title,id,release_date,production_budget,domestic_gross,worldwide_gross,profit
Avatar,1,2009-12-18,425000000,760507625,2776345279,2351345279
Pirates of the Caribbean: On Stranger Tides,2,2011-05-20,410600000,241063875,1045663875,635063875
Avengers: Age of Ultron,4,2015-05-01,330600000,459005868,1403013963,1072413963
Star Wars Ep. VIII: The Last Jedi,5,2017-12-15,317000000,620181382,1316721747,999721747
Star Wars Ep. VII: The Force Awakens,6,2015-12-18,306000000,936662225,2053311220,1747311220
Avengers: Infinity War,7,2018-04-27,300000000,678815482,2048134200,1748134200
Pirates of the Caribbean: At Worldâs End,8,2007-05-24,300000000,309420425,963420425,663420425
Justice League,9,2017-11-17,300000000,229024295,655945209,355945209
Spectre,10,2015-11-06,300000000,200074175,879620923,579620923
The Dark Knight Rises,11,2012-07-20,275000000,448139099,1084439099,809439099
Solo: A Star Wars Story,12,2018-05-25,275000000,213767512,393151347,118151347
The Lone Ranger,13,2013-07-02,275000000,89302115,260002115,-14997885
John Carter,14,2012-03-09,275000000,73058679,282778100,7778100
Tangled,15,2010-11-24,260000000,200821936,586477240,326477240
Spider-Man 3,16,2007-05-04,258000000,336530303,894860230,636860230
Captain America: Civil War,17,2016-05-06,250000000,408084349,1140069413,890069413
Batman v Superman: Dawn of Justice,18,2016-03-25,250000000,330360194,867500281,617500281
The Hobbit: An Unexpected Journey,19,2012-12-14,250000000,303003568,1017003568,767003568
Harry Potter and the Half-Blood Prince,20,2009-07-15,250000000,302089278,935213767,685213767
The Hobbit: The Desolation of Smaug,21,2013-12-13,250000000,258366855,960366855,710366855
The Hobbit: The Battle of the Five Armies,22,2014-12-17,250000000,255119788,945577621,695577621
The Fate of the Furious,23,2017-04-14,250000000,225764765,1234846267,984846267
Superman Returns,24,2006-06-28,232000000,200120000,374085065,142085065
Pirates of the Caribbean: Dead Men Tell No Tales,25,2017-05-26,230000000,172558876,788241137,558241137
Quantum of Solace,26,2008-11-14,230000000,169368427,591692078,361692078
The Avengers,27,2012-05-04,225000000,623279547,1517935897,1292935897
Pirates of the Caribbean: Dead Manâs Chest,28,2006-07-07,225000000,423315812,1066215812,841215812
Man of Steel,29,2013-06-14,225000000,291045518,667999518,442999518
The Chronicles of Narnia: Prince Caspian,30,2008-05-16,225000000,141621490,417341288,192341288
The Amazing Spider-Man,31,2012-07-03,220000000,262030663,757890267,537890267
Battleship,32,2012-05-18,220000000,65233400,313477717,93477717
Transformers: The Last Knight,33,2017-06-21,217000000,130168683,602893340,385893340
Jurassic World,34,2015-06-12,215000000,652270625,1648854864,1433854864
Men in Black 3,35,2012-05-25,215000000,179020854,654213485,439213485
Transformers: Revenge of the Fallen,36,2009-06-24,210000000,402111870,836519699,626519699
Transformers: Age of Extinction,37,2014-06-27,210000000,245439076,1104039076,894039076
X-Men: The Last Stand,38,2006-05-26,210000000,234362462,459260946,249260946
Robin Hood,39,2010-05-14,210000000,105487148,322459006,112459006
King Kong,40,2005-12-14,207000000,218080025,550517357,343517357
The Golden Compass,41,2007-12-07,205000000,70107728,367262558,162262558
Black Panther,42,2018-02-16,200000000,700059566,1348258224,1148258224
Incredibles 2,44,2018-06-15,200000000,608581744,1242520711,1042520711
Rogue One: A Star Wars Story,45,2016-12-16,200000000,532177324,1049102856,849102856
Finding Dory,46,2016-06-17,200000000,486295561,1021215193,821215193
Toy Story 3,47,2010-06-18,200000000,415004880,1068879522,868879522
Iron Man 3,48,2013-05-03,200000000,408992272,1215392272,1015392272
Guardians of the Galaxy Vol 2,49,2017-05-05,200000000,389813101,862316233,662316233
Spider-Man 2,50,2004-06-30,200000000,373524485,795110670,595110670
Alice in Wonderland,51,2010-03-05,200000000,334191110,1025491110,825491110
Skyfall,52,2012-11-08,200000000,304360277,1110526981,910526981
Monsters University,53,2013-06-21,200000000,268488329,743588329,543588329
Oz the Great and Powerful,54,2013-03-08,200000000,234770996,490359051,290359051
X-Men: Days of Future Past,55,2014-05-23,200000000,233921534,747862775,547862775
The Amazing Spider-Man 2,56,2014-05-02,200000000,202853933,708996336,508996336
Cars 2,57,2011-06-24,200000000,191450875,560155383,360155383
Tron: Legacy,58,2010-12-17,200000000,172062763,400062763,200062763
2012,59,2009-11-13,200000000,166112167,757677748,557677748
Fantastic Beasts: The Crimes of Grindelwald,60,2018-11-16,200000000,159555901,652220086,452220086
Terminator Salvation,61,2009-05-21,200000000,125322469,365491792,165491792
Green Lantern,62,2011-06-17,200000000,116601172,219535492,19535492
Prince of Persia: Sands of Time,63,2010-05-28,200000000,90759676,336359676,136359676
Transformers: Dark of the Moon,64,2011-06-29,195000000,352390543,1123790543,928790543
The Mummy,65,2017-06-09,195000000,80101125,409953905,214953905
Jack the Giant Slayer,66,2013-03-01,195000000,65187603,197687603,2687603
Furious 7,67,2015-04-03,190000000,353007020,1518722794,1328722794
Star Trek Into Darkness,68,2013-05-16,190000000,228778661,467381584,277381584
World War Z,69,2013-06-21,190000000,202359711,531514650,341514650
The Great Gatsby,70,2013-05-10,190000000,144840419,351040419,161040419
Disneyâs A Christmas Carol,71,2009-11-06,190000000,137855863,315709697,125709697
Pacific Rim,72,2013-07-12,190000000,101802906,411002906,221002906
The Good Dinosaur,73,2015-11-25,187500000,123087120,333771037,146271037
Iron Man,74,2008-05-02,186000000,318604126,585171547,399171547
The Dark Knight,75,2008-07-18,185000000,533720947,1001996207,816996207
Indiana Jones and the Kingdom of the Crystal Skull,76,2008-05-22,185000000,317101119,786635413,601635413
Brave,77,2012-06-22,185000000,237282182,554606532,369606532
Kong: Skull Island,78,2017-03-10,185000000,168052812,561072059,376072059
Star Trek Beyond,79,2016-07-22,185000000,158848340,335802233,150802233
Blade Runner 2049,80,2017-10-06,185000000,92054159,259357408,74357408
Thor: Ragnarok,82,2017-11-03,180000000,315058289,846980024,666980024
"The Chronicles of Narnia: The Lion, the Witch and the Wardrobe",83,2005-12-09,180000000,291710957,720539572,540539572
Maleficent,84,2014-05-30,180000000,241407328,758536735,578536735
Fantastic Beasts and Where to Find Them,85,2016-11-18,180000000,234037575,802402853,622402853
WALL-E,86,2008-06-27,180000000,223808164,532508025,352508025
Rush Hour 3,87,2007-08-10,180000000,140125968,256585882,76585882
The Legend of Tarzan,88,2016-07-01,180000000,126643061,348902025,168902025
Hugo,89,2011-11-23,180000000,73864507,180047784,47784
Valerian and the City of a Thousand Planets,90,2017-07-21,180000000,40479370,215098356,35098356
Jupiter Ascending,91,2015-02-06,179000000,47482519,181982519,2982519
Mission: ImpossibleâFallout,92,2018-07-27,178000000,220159104,787456552,609456552
X-Men: Apocalypse,93,2016-05-27,178000000,155442489,542537546,364537546
The Meg,94,2018-08-10,178000000,145443742,529530715,351530715
Edge of Tomorrow,95,2014-06-06,178000000,100206256,370541256,192541256
The Jungle Book,97,2016-04-15,175000000,364001123,962854547,787854547
Inside Out,98,2015-06-19,175000000,356461711,854235992,679235992
Spider-Man: Homecoming,99,2017-07-07,175000000,334201140,880166350,705166350
Suicide Squad,100,2016-08-05,175000000,325100054,746059887,571059887
Up,1,2009-05-29,175000000,293004164,731463377,556463377
Coco,2,2017-11-22,175000000,209726015,798008101,623008101
Ralph Breaks The Internet,3,2018-11-21,175000000,201091711,524283695,349283695
Monsters vs. Aliens,4,2009-03-27,175000000,198351526,381687380,206687380
Cars 3,5,2017-06-16,175000000,152901115,383541369,208541369
G.I. Joe: The Rise of Cobra,6,2009-08-07,175000000,150201498,302469017,127469017
The Mummy: Tomb of the Dragon Emperor,8,2008-08-01,175000000,102491776,405760225,230760225
Evan Almighty,9,2007-06-22,175000000,100289690,174131329,-868671
King Arthur: Legend of the Sword,11,2017-05-12,175000000,39175066,139630336,-35369664
47 Ronin,12,2013-12-25,175000000,38362475,151716815,-23283185
Jurassic World: Fallen Kingdom,13,2018-06-22,170000000,417719760,1305772799,1135772799
Guardians of the Galaxy,14,2014-08-01,170000000,333172112,770867516,600867516
Iron Man 2,15,2010-05-07,170000000,312433331,621156389,451156389
Captain America: The Winter Soldier,16,2014-04-04,170000000,259746958,714401889,544401889
Dawn of the Planet of the Apes,17,2014-07-11,170000000,208545589,710644566,540644566
The Polar Express,18,2004-11-10,170000000,187224605,311365187,141365187
Snow White and the Huntsman,19,2012-06-01,170000000,155136755,401021746,231021746
Terminator 3: Rise of the Machines,20,2003-07-01,170000000,150358296,433058296,263058296
Van Helsing,21,2004-05-07,170000000,120150546,300150546,130150546
Tomorrowland,23,2015-05-22,170000000,93436322,206627518,36627518
Alice Through the Looking Glass,26,2016-05-27,170000000,77042381,276928112,106928112
Shrek Forever After,27,2010-05-21,165000000,238736787,756244673,591244673
Doctor Strange,28,2016-11-04,165000000,232641920,676404566,511404566
Big Hero 6,29,2014-11-07,165000000,222527828,652127828,487127828
How to Train Your Dragon,30,2010-03-26,165000000,217581232,494870992,329870992
Wreck-It Ralph,31,2012-11-02,165000000,189412677,496511521,331511521
Interstellar,32,2014-11-05,165000000,188017894,666379375,501379375
Independence Day: Resurgence,33,2016-06-24,165000000,103144286,384169424,219169424
Cowboys and Aliens,34,2011-07-29,163000000,100368560,176038324,13038324
Beauty and the Beast,35,2017-03-17,160000000,504014165,1259199706,1099199706
Aquaman,36,2018-12-21,160000000,335061807,1146894640,986894640
Shrek the Third,37,2007-05-17,160000000,322719944,807330936,647330936
Inception,38,2010-07-16,160000000,292576195,835524642,675524642
The Hunger Games: Mockingjay - Part 2,39,2015-11-20,160000000,281723902,648986787,488986787
Fast and Furious 6,40,2013-05-24,160000000,238679850,789300444,629300444
Godzilla,41,2014-05-16,160000000,200676069,529076069,369076069
X-Men: First Class,42,2011-06-03,160000000,146408305,355408305,195408305
The Curious Case of Benjamin Button,43,2008-12-25,160000000,127509326,329631958,169631958
The Sorcerer's Apprentice,44,2010-07-14,160000000,63150991,217986320,57986320
Poseidon,45,2006-05-12,160000000,60674817,181674817,21674817
Warcraft,46,2016-06-10,160000000,47225655,425522281,265522281
Deepwater Horizon,47,2016-09-30,156000000,61433527,122603824,-33396176
The Chronicles of Narnia: The Voyage of the Dawn Treader,48,2010-12-10,155000000,104386950,418186950,263186950
Terminator: Genisys,49,2015-07-01,155000000,89760956,432150894,277150894
Pacific Rim: Uprising,50,2018-03-23,155000000,59874525,290930148,135930148
Alexander,51,2004-11-24,155000000,34297191,167297191,12297191
War for the Planet of the Apes,52,2017-07-14,152000000,146880162,489592267,337592267
Pearl Harbor,53,2001-05-25,151500000,198539855,449239855,297739855
Transformers,54,2007-07-02,151000000,319246193,708272592,557272592
Wonder Woman,55,2017-06-02,150000000,412563408,821133378,671133378
Frozen,56,2013-11-22,150000000,400738009,1272469910,1122469910
Zootopia,57,2016-03-04,150000000,341268248,1019429616,869429616
Harry Potter and the Order of the Phoenix,58,2007-07-11,150000000,292137260,943076457,793076457
Harry Potter and the Goblet of Fire,59,2005-11-18,150000000,290201752,897099794,747099794
The Matrix Reloaded,60,2003-05-15,150000000,281553689,738576929,588576929
I am Legend,61,2007-12-14,150000000,256393010,585532684,435532684
Moana,62,2016-11-23,150000000,248757044,637517365,487517365
Hancock,63,2008-07-01,150000000,227946274,624234272,474234272
Charlie and the Chocolate Factory,64,2005-07-15,150000000,206459076,475825484,325825484
Ratatouille,65,2007-06-29,150000000,206445654,626549695,476549695
Thor: The Dark World,66,2013-11-08,150000000,206362140,644602516,494602516
Batman Begins,67,2005-06-15,150000000,205343774,359142722,209142722
Mission: ImpossibleâRogue Nation,68,2015-07-31,150000000,195042377,688858992,538858992
Dunkirk,69,2017-07-21,150000000,190068280,499837368,349837368
Thor,70,2011-05-06,150000000,181030624,449326618,299326618
Madagascar: Escape 2 Africa,71,2008-11-07,150000000,180174880,599680774,449680774
X-Men Origins: Wolverine,72,2009-05-01,150000000,179883157,374825760,224825760
Night at the Museum: Battle of the Smithsonian,73,2009-05-22,150000000,177243721,402231063,252231063
Kung Fu Panda 2,74,2011-05-26,150000000,165249063,664837547,514837547
Mad Max: Fury Road,75,2015-05-15,150000000,153636354,370098020,220098020
The Matrix Revolutions,77,2003-11-05,150000000,139270910,427300260,277300260
Ready Player One,78,2018-03-29,150000000,137690172,579290136,429290136
Chicken Little,79,2005-11-04,150000000,135386665,310043823,160043823
Mission: Impossible III,80,2006-05-05,150000000,133501348,397501348,247501348
Angels & Demons,81,2009-05-15,150000000,133375846,490875846,340875846
Troy,82,2004-05-14,150000000,133298577,484161265,334161265
The Last Airbender,83,2010-07-01,150000000,131772187,319713881,169713881
Bee Movie,84,2007-11-02,150000000,126631277,287594577,137594577
G-Force,85,2009-07-24,150000000,119436770,292817841,142817841
Bolt,86,2008-11-21,150000000,114053579,328015029,178015029
Wrath of the Titans,87,2012-03-30,150000000,83670083,305270083,155270083
Beowulf,88,2007-11-16,150000000,82280579,195080579,45080579
Dark Shadows,89,2012-05-11,150000000,79727149,238202668,88202668
White House Down,90,2013-06-28,150000000,73103784,205440387,55440387
The Wolfman,91,2010-02-12,150000000,62189884,142634358,-7365642
The Great Wall,92,2017-02-17,150000000,45157105,334486852,184486852
Pan,93,2015-10-09,150000000,35088320,151525973,1525973
Mars Needs Moms,94,2011-03-11,150000000,21392758,39549758,-110450242
Flushed Away,96,2006-11-03,149000000,64665672,179357126,30357126
Madagascar 3: Europe's Most Wanted,97,2012-06-08,145000000,216391482,746921271,601921271
Mission: ImpossibleâGhost Protocol,98,2011-12-16,145000000,209397903,694713230,549713230
How to Train Your Dragon 2,99,2014-06-13,145000000,177002924,614586270,469586270
Mr. Peabody & Sherman,1,2014-03-07,145000000,111506430,269806430,124806430
Rise of the Guardians,2,2012-11-21,145000000,103412758,306900902,161900902
Sahara,3,2005-04-08,145000000,68671925,121671925,-23328075
Ghostbusters,4,2016-07-15,144000000,128350574,229008658,85008658
Die Another Day,5,2002-11-22,142000000,160942139,431942139,289942139
Pirates of the Caribbean: The Curse of the Black Pearl,6,2003-07-09,140000000,305411224,634954103,494954103
Star Trek,7,2009-05-08,140000000,257730019,386839614,246839614
Men in Black 2,9,2002-07-03,140000000,190418803,441767803,301767803
Captain America: The First Avenger,10,2011-07-22,140000000,176654505,370569776,230569776
Kung Fu Panda 3,11,2016-01-29,140000000,143528619,517599142,377599142
G.I. Joe: Retaliation,13,2013-03-27,140000000,122523060,375740705,235740705
The Last Samurai,14,2003-12-05,140000000,111110575,456810575,316810575
Fun With Dick And Jane,15,2005-12-21,140000000,110550000,203018919,63018919
Exodus: Gods and Kings,16,2014-12-12,140000000,65014513,268314513,128314513
The BFG,17,2016-07-01,140000000,55483770,199646680,59646680
Gods of Egypt,18,2016-02-26,140000000,31153464,138836756,-1163244
Spider-Man,19,2002-05-03,139000000,403706375,821706375,682706375
Watchmen,20,2009-03-06,138000000,107509799,186976250,48976250
Stealth,21,2005-07-29,138000000,32116746,76416746,-61583254
The Incredible Hulk,22,2008-06-13,137500000,134806913,265573859,128073859
Hulk,23,2003-06-20,137000000,132177234,245075434,108075434
Final Fantasy: The Spirits Within,24,2001-07-11,137000000,32131830,85131830,-51868170
"The Twilight Saga: Breaking Dawn, Part 2",25,2012-11-16,136200000,292324737,829724737,693524737
The Croods,26,2013-03-22,135000000,187168425,573068425,438068425
The Revenant,27,2015-12-25,135000000,183637894,532938302,397938302
Rango,29,2011-03-04,135000000,123477607,245724600,110724600
Master and Commander: The Far Side of the World,30,2003-11-14,135000000,93926386,212912137,77912137
Turbo,31,2013-07-17,135000000,83028130,286896578,151896578
Teenage Mutant Ninja Turtles: Out of the Shadows,32,2016-06-03,135000000,82051601,245328374,110328374
Happy Feet Two,33,2011-11-18,135000000,64006466,157956466,22956466
Miami Vice,34,2006-07-28,135000000,63478838,163818556,28818556
The Nutcracker and the Four Realms,35,2018-11-02,132900000,54858851,170293899,37393899
War of the Worlds,36,2005-06-29,132000000,234280354,606836535,474836535
Penguins of Madagascar,37,2014-11-26,132000000,83350911,366942531,234942531
The Hunger Games: Catching Fire,38,2013-11-22,130000000,424668047,864868047,734868047
Harry Potter and the Prisoner of Azkaban,39,2004-06-04,130000000,249757726,796907323,666907323
The Bourne Ultimatum,40,2007-08-03,130000000,227471070,444043396,314043396
Ant-Man and the Wasp,41,2018-07-06,130000000,216648740,623144660,493144660
Kung Fu Panda,42,2008-06-06,130000000,215434591,631910531,501910531
Ant-Man,43,2015-07-17,130000000,180202163,518858449,388858449
Home,44,2015-03-27,130000000,177397510,385997896,255997896
Mary Poppins Returns,45,2018-12-19,130000000,171958438,341528518,211528518
Puss in Boots,46,2011-10-28,130000000,149260504,554987477,424987477
Megamind,47,2010-11-05,130000000,148415853,321887208,191887208
Bad Boys II,48,2003-07-18,130000000,138540870,273271982,143271982
Rio 2,49,2014-04-11,130000000,131538435,492846291,362846291
Salt,50,2010-07-23,130000000,118311368,290650494,160650494
Noah,51,2014-03-28,130000000,101200044,352831065,222831065
The Adventures of Tintin,52,2011-12-21,130000000,77591831,373993951,243993951
After Earth,53,2013-05-31,130000000,60522097,251499665,121499665
Australia,54,2008-11-26,130000000,49554002,215080810,85080810
R.I.P.D.,55,2013-07-19,130000000,33618855,79076678,-50923322
"The Twilight Saga: Breaking Dawn, Part 1",57,2011-11-18,127500000,281287133,689420051,561920051
Dinosaur,58,2000-05-19,127500000,137748063,356148063,228648063
Logan,59,2017-03-03,127000000,226277068,615461394,488461394
Night at the Museum: Secret of the Tomb,60,2014-12-19,127000000,113746621,353756621,226756621
Harry Potter and the Deathly Hallows: Part II,61,2011-07-15,125000000,381193157,1341693157,1216693157
The Hunger Games: Mockingjay - Part 1,62,2014-11-21,125000000,337135885,766575131,641575131
Harry Potter and the Sorcererâs Stone,63,2001-11-16,125000000,317871467,975047606,850047606
Harry Potter and the Deathly Hallows: Part I,64,2010-11-19,125000000,296131568,960431568,835431568
The Da Vinci Code,65,2006-05-19,125000000,217536138,767820459,642820459
X-Men 2,66,2003-05-02,125000000,214949694,406875536,281875536
Fast Five,67,2011-04-29,125000000,210031325,630163454,505163454
Teenage Mutant Ninja Turtles,68,2014-08-08,125000000,191204754,485004754,360004754
Sherlock Holmes: A Game of Shadows,69,2011-12-16,125000000,186848418,535663443,410663443
The Day After Tomorrow,70,2004-05-28,125000000,186740799,556319450,431319450
The Boss Baby,71,2017-03-31,125000000,175003033,510878762,385878762
Clash of the Titans,72,2010-04-01,125000000,163214888,493214888,368214888
Trolls,73,2016-11-04,125000000,153707064,344150134,219150134
Prometheus,75,2012-06-08,125000000,126477084,402448265,277448265
The Bourne Legacy,76,2012-08-10,125000000,113203870,280355920,155355920
Skyscraper,78,2018-07-13,125000000,68420120,304115534,179115534
Total Recall,79,2012-08-03,125000000,58877969,211856088,86856088
Assassinâs Creed,80,2016-12-21,125000000,54647948,240759682,115759682
Monster Trucks,81,2017-01-13,125000000,33370166,61642798,-63357202
How the Grinch Stole Christmas,83,2000-11-17,123000000,260044825,345141403,222141403
Mission: Impossible 2,84,2000-05-24,120000000,215409889,549588516,429588516
The Perfect Storm,85,2000-06-30,120000000,182618434,328711434,208711434
Jason Bourne,86,2016-07-29,120000000,162192920,416168316,296168316
Fantastic Four: Rise of the Silver Surfer,87,2007-06-15,120000000,131921738,289480691,169480691
Life of Pi,88,2012-11-21,120000000,124987022,620912003,500912003
Ghost Rider,89,2007-02-16,120000000,115802596,229545589,109545589
Rampage,90,2018-04-13,120000000,101028233,428056280,308056280
Charlie's Angels: Full Throttle,91,2003-06-27,120000000,100814328,227200000,107200000
Elysium,92,2013-08-09,120000000,93050117,286192091,166192091
Oblivion,93,2013-04-19,120000000,89107235,287916633,167916633
Power Rangers,94,2017-03-24,120000000,85364450,142531552,22531552
Stuart Little 2,95,2002-07-19,120000000,64956806,166000000,46000000
RoboCop,96,2014-02-12,120000000,58607007,242981799,122981799
The Chronicles of Riddick,97,2004-06-11,120000000,57712751,107212751,-12787249
Fantastic Four,98,2015-08-07,120000000,56117548,167849187,47849187
Speed Racer,99,2008-05-09,120000000,43945766,93394462,-26605538
The Island,100,2005-07-22,120000000,35818913,163018913,43018913
How Do You Know?,1,2010-12-17,120000000,30212620,49628177,-70371823
Knight and Day,2,2010-06-23,117000000,76423035,258751370,141751370
Venom,3,2018-10-05,116000000,213511408,853628605,737628605
Star Wars Ep. III: Revenge of the Sith,5,2005-05-19,115000000,380270577,848998877,733998877
Star Wars Ep. II: Attack of the Clones,6,2002-05-16,115000000,310676740,656695615,541695615
"Monsters, Inc.",7,2001-11-02,115000000,289423425,559757719,444757719
The Wolverine,8,2013-07-26,115000000,132556852,416456852,301456852
The Huntsman: Winterâs War,10,2016-04-22,115000000,48003015,165149302,50149302
Windtalkers,11,2002-06-14,115000000,40914068,77628265,-37371735
AstÃ©rix aux Jeux Olympiques,12,2008-07-04,113500000,999811,132999811,19499811
Gulliver's Travels,13,2010-12-25,112000000,42779261,232017848,120017848
Ferdinand,14,2017-12-15,111000000,84410380,289847930,178847930
Deadpool 2,15,2018-05-18,110000000,324591735,786680557,676680557
Gravity,16,2013-10-04,110000000,274092705,693698673,583698673
Night at the Museum,17,2006-12-22,110000000,250863268,579446407,469446407
Mr. and Mrs. Smith,18,2005-06-10,110000000,186336279,486124090,376124090
San Andreas,19,2015-05-29,110000000,155190832,456258539,346258539
The Smurfs,20,2011-07-29,110000000,142614158,563749323,453749323
Live Free or Die Hard,21,2007-06-27,110000000,134529403,382288147,272288147
The Divergent Series: Insurgent,22,2015-03-20,110000000,130179072,295075882,185075882
Ocean's Twelve,23,2004-12-10,110000000,125531634,362989076,252989076
The Patriot,25,2000-06-28,110000000,113330342,215300000,105300000
300: Rise of an Empire,26,2014-03-07,110000000,106580051,330780051,220780051
The Aviator,27,2004-12-17,110000000,102608827,208370892,98370892
Passengers,28,2016-12-21,110000000,100014699,302239672,192239672
The Green Hornet,29,2011-01-14,110000000,98780042,229155503,119155503
Miss Peregrineâs Home for Peculiar Children,30,2016-09-30,110000000,87242834,295986876,185986876
Real Steel,31,2011-10-07,110000000,85463309,263880341,153880341
The A-Team,32,2010-06-11,110000000,77222099,177241171,67241171
The Smurfs 2,33,2013-07-31,110000000,71017784,348547523,238547523
The Divergent Series: Allegiant,34,2016-03-18,110000000,66184051,172022517,62022517
The Taking of Pelham 123,35,2009-06-12,110000000,65452312,152364370,42364370
Ender's Game,36,2013-11-01,110000000,61737191,127983283,17983283
Home on the Range,37,2004-04-02,110000000,50026353,76482461,-33517539
Kingdom of Heaven,39,2005-05-06,110000000,47398413,218853353,108853353
Ghost in the Shell,40,2017-03-31,110000000,40563557,167910690,57910690
Around the World in 80 Days,41,2004-06-16,110000000,24004159,72004159,-37995841
The Lord of the Rings: The Fellowship of the Ring,43,2001-12-19,109000000,315544750,887210985,778210985
The Cat in the Hat,44,2003-11-21,109000000,101018283,133818283,24818283
Ali,45,2001-12-25,109000000,58183966,87683966,-21316034
The Martian,46,2015-10-02,108000000,228433663,655271443,547271443
Allied,47,2016-11-23,106000000,40098064,119266661,13266661
"I, Robot",48,2004-07-16,105000000,144801023,348629585,243629585
The Princess and the Frog,50,2009-11-25,105000000,104400899,270997378,165997378
"10,000 B.C.",51,2008-03-07,105000000,94784201,269065678,164065678
Ice Age: Collision Course,52,2016-07-22,105000000,64063008,402156682,297156682
Town & Country,53,2001-04-27,105000000,6712451,10364769,-94635231
Kingsman: The Golden Circle,54,2017-09-22,104000000,100234838,408803696,304803696
Gone in 60 Seconds,55,2000-06-09,103300000,101643008,232643008,129343008
Gladiator,56,2000-05-05,103000000,187683805,457683805,354683805
The Hangover 3,57,2013-05-23,103000000,112200072,362000072,259000072
A Wrinkle in Time,58,2018-03-09,103000000,100478608,133401882,30401882
Public Enemies,59,2009-07-01,102500000,97104620,212282709,109782709
Casino Royale,60,2006-11-17,102000000,167365000,594420283,492420283
Minority Report,61,2002-06-21,102000000,132024714,358824714,256824714
Bumblebee,62,2018-12-21,102000000,127195589,465195589,363195589
Cloud Atlas,63,2012-10-26,102000000,27108272,130673154,28673154
Harry Potter and the Chamber of Secrets,64,2002-11-15,100000000,262233381,879225135,779225135
Planet of the Apes,67,2001-07-27,100000000,180011740,362211740,262211740
National Treasure,68,2004-11-19,100000000,173005002,331323410,231323410
Django Unchained,69,2012-12-25,100000000,162805434,449948323,349948323
Little Fockers,70,2010-12-22,100000000,148438600,310650574,210650574
American Gangster,72,2007-11-02,100000000,130164645,267985456,167985456
Cloudy with a Chance of Meatballs,73,2009-09-18,100000000,124870275,236827677,136827677
The Other Guys,74,2010-08-06,100000000,119219978,170936470,70936470
Lemony Snicket's A Series of Unfortunate Events,75,2004-12-17,100000000,118627117,212956024,112956024
The Wolf of Wall Street,76,2013-12-25,100000000,116900694,389870414,289870414
Epic,77,2013-05-24,100000000,107518682,262794441,162794441
The Emperor's New Groove,80,2000-12-15,100000000,89296573,169296573,69296573
The Expendables 2,81,2012-08-17,100000000,85028192,311979256,211979256
Where the Wild Things Are,82,2009-10-16,100000000,77233467,99123656,-876344
Eragon,83,2006-12-15,100000000,75030163,249488115,149488115
Hercules,84,2014-07-25,100000000,72688614,243388614,143388614
The Tourist,85,2010-12-10,100000000,67631157,278731369,178731369
The Stepford Wives,87,2004-06-11,100000000,59475623,96221971,-3778029
Surf's Up,88,2007-06-08,100000000,58867694,145395745,45395745
Blood Diamond,89,2006-12-08,100000000,57377916,171377916,71377916
Legend of the Guardians: The Owls of Ga'Hoole,90,2010-09-24,100000000,55675313,139716717,39716717
Land of the Lost,92,2009-06-05,100000000,49438370,69548641,-30451359
Peter Pan,93,2003-12-25,100000000,48417850,95255485,-4744515
Catwoman,95,2004-07-23,100000000,40202379,82145379,-17854621
The Expendables 3,96,2014-08-15,100000000,39322544,209461378,109461378
Treasure Planet,97,2002-11-27,100000000,38120554,91800000,-8200000
Green Zone,98,2010-03-12,100000000,35497337,97523020,-2476980
Geostorm,99,2017-10-20,100000000,33700160,220796009,120796009
Point Break,100,2015-12-25,100000000,28782481,126704591,26704591
In the Heart of the Sea,1,2015-12-11,100000000,25020758,89693309,-10306691
Transcendence,2,2014-04-18,100000000,23022309,103039258,3039258
Son of the Mask,3,2005-02-18,100000000,17018422,59918422,-40081578
Mortal Engines,4,2018-12-14,100000000,15951040,85287417,-14712583
The Adventures of Pluto Nash,5,2002-08-16,100000000,4411102,7094995,-92905005
Jin lÃ­ng shÃ­ san chai,6,2012-01-20,100000000,311434,98227017,-1772983
The Peanuts Movie,7,2015-11-06,99000000,130178411,250091610,151091610
Robin Hood,9,2018-11-21,99000000,30824628,84747441,-14252559
The Mummy Returns,10,2001-05-04,98000000,202007640,435040395,337040395
Gangs of New York,11,2002-12-20,97000000,77730500,183124621,86124621
Alien: Covenant,12,2017-05-19,97000000,74262031,238521247,141521247
Cinderella,13,2015-03-13,95000000,201151353,534551353,439551353
Ice Age: Continental Drift,14,2012-07-13,95000000,161321843,879765137,784765137
Black Hawk Down,15,2001-12-28,95000000,108638745,159691085,64691085
Sex and the City 2,16,2010-05-27,95000000,95347692,294680778,199680778
Percy Jackson & the Olympians: The Lightning Thief,17,2010-02-12,95000000,88768303,223050874,128050874
The Campaign,18,2012-08-10,95000000,86907746,104907746,9907746
Unstoppable,19,2010-11-12,95000000,81562942,165720921,70720921
The Road to El Dorado,21,2000-03-31,95000000,50802661,65700000,-29300000
The Lovely Bones,22,2009-12-11,95000000,44114232,94894448,-105552
Ben-Hur,23,2016-08-19,95000000,26410477,91669648,-3330352
Seventh Son,24,2015-02-06,95000000,17725785,108874967,13874967
Finding Nemo,25,2003-05-30,94000000,380529370,936429370,842429370
The Lord of the Rings: The Return of the King,26,2003-12-17,94000000,377845905,1141403341,1047403341
The Lord of the Rings: The Two Towers,27,2002-12-18,94000000,342548984,934699645,840699645
Lara Croft: Tomb Raider,28,2001-06-15,94000000,131144183,273330185,179330185
Kingsman: The Secret Service,29,2015-02-13,94000000,128261724,404561724,310561724
Jurassic Park III,30,2001-07-18,93000000,181166115,365900000,272900000
Rise of the Planet of the Apes,31,2011-08-05,93000000,176760185,470986200,377986200
The Spiderwick Chronicles,32,2008-02-14,92500000,71195053,162839667,70339667
The Incredibles,33,2004-11-05,92000000,261441092,614726752,522726752
A Good Day to Die Hard,34,2013-02-14,92000000,67349198,304249198,212249198
The Alamo,35,2004-04-09,92000000,22406362,23911362,-68088638
The Secret Life of Walter Mitty,37,2013-12-25,91000000,58236838,187861183,96861183
Jumanji: Welcome to the Jungle,38,2017-12-20,90000000,404508916,964496193,874496193
Rush Hour 2,41,2001-08-03,90000000,226164286,347425832,257425832
Sherlock Holmes,42,2009-12-25,90000000,209028679,498438212,408438212
Ice Age: Dawn of the Dinosaurs,43,2009-07-01,90000000,196573705,859701857,769701857
Spider-Man: Into The Spider-Verse 3D,44,2018-12-14,90000000,190173195,375381768,285381768
What Lies Beneath,45,2000-07-21,90000000,155464351,288693989,198693989
Rio,46,2011-04-15,90000000,143619809,487519809,397519809
The Departed,47,2006-10-06,90000000,132384315,289660619,199660619
Charlie's Angels,48,2000-11-03,90000000,125305545,259736090,169736090
Tropic Thunder,50,2008-08-13,90000000,110515313,191145256,101145256
The Girl with the Dragon Tattoo,51,2011-12-20,90000000,102515793,239373970,149373970
You Don't Mess With the Zohan,53,2008-06-06,90000000,100018837,202910991,112910991
The Magnificent Seven,55,2016-09-23,90000000,93432655,162525156,72525156
Alvin and the Chipmunks: The Road Chip,56,2015-12-18,90000000,85886987,249517956,159517956
Atlantis: The Lost Empire,57,2001-06-08,90000000,84052762,186049020,96049020
Valkyrie,58,2008-12-25,90000000,83107829,203932174,113932174
Pixels,59,2015-07-24,90000000,78765986,244041804,154041804
Artificial Intelligence: AI,60,2001-06-29,90000000,78616689,235900000,145900000
The Haunted Mansion,61,2003-11-26,90000000,75817994,155750628,65750628
Hollow Man,62,2000-08-04,90000000,73209340,191200000,101200000
The Interpreter,63,2005-04-22,90000000,72708161,162753837,72753837
Percy Jackson: Sea of Monsters,64,2013-08-07,90000000,68559554,200859554,110859554
Lara Croft: Tomb Raider: The Cradle of Life,65,2003-07-25,90000000,65653758,157092943,67092943
Now You See Me 2,66,2016-06-10,90000000,65075540,328325007,238325007
Spy Game,67,2001-11-21,90000000,62362560,143049560,53049560
Mission to Mars,69,2000-03-10,90000000,60874615,106000000,16000000
Tomb Raider,70,2018-03-16,90000000,58250803,273477501,183477501
King Arthur,72,2004-07-07,90000000,51877963,203877963,113877963
K-19: The Widowmaker,75,2002-07-19,90000000,35168966,65716126,-24283874
Conan the Barbarian,76,2011-08-19,90000000,21295021,63356133,-26643867
The Three Musketeers,77,2011-10-21,90000000,20377913,139877913,49877913
The Promise,78,2017-04-21,90000000,8224288,10551417,-79448583
The Nutcracker in 3D,79,2010-11-24,90000000,195459,20466016,-69533984
Bright,80,2017-12-13,90000000,0,0,-90000000
Cinderella Man,83,2005-06-03,88000000,61649911,105021488,17021488
The Predator,84,2018-09-14,88000000,51024708,159487563,71487563
Fantastic Four,85,2005-07-08,87500000,154696080,333132750,245632750
Hannibal,86,2001-02-09,87000000,165092266,350100280,263100280
Seabiscuit,87,2003-07-25,86000000,120277854,148715342,62715342
Cast Away,88,2000-12-22,85000000,233632142,427230516,342230516
Happy Feet,89,2006-11-17,85000000,198000317,385000317,300000317
Ocean's Eleven,90,2001-12-07,85000000,183417150,450728529,365728529
The Bourne Supremacy,91,2004-07-23,85000000,176087450,311001124,226001124
Fast & Furious,93,2009-04-03,85000000,155064265,363064265,278064265
Horton Hears a Who,94,2008-03-14,85000000,154529439,299477886,214477886
Divergent,95,2014-03-21,85000000,150947895,276014965,191014965
Hotel Transylvania,96,2012-09-28,85000000,148313048,378505812,293505812
Enchanted,98,2007-11-21,85000000,127706877,340384141,255384141
Safe House,99,2012-02-10,85000000,126181630,208542162,123542162
I Now Pronounce You Chuck and Larry,100,2007-07-20,85000000,119725280,185708462,100708462
Ocean's Thirteen,1,2007-06-08,85000000,117144465,311744465,226744465
Itâs Complicated,2,2009-12-25,85000000,112735375,224614744,139614744
Open Season,4,2006-09-29,85000000,85105259,191932158,106932158
Tower Heist,5,2011-11-04,85000000,78046570,150422946,65422946
102 Dalmatians,6,2000-11-22,85000000,66941559,66941559,-18058441
Mirror Mirror,7,2012-03-30,85000000,64935167,173613482,88613482
The Holiday,8,2006-12-08,85000000,63280000,205190324,120190324
The Fast and the Furious: Tokyo Drift,9,2006-06-16,85000000,62615510,157794205,72794205
Memoirs of a Geisha,10,2005-12-09,85000000,57010853,161510853,76510853
Enemy at the Gates,11,2001-03-16,85000000,51396781,96971293,11971293
The Rundown,13,2003-09-26,85000000,47641743,80831893,-4168107
Arthur Christmas,14,2011-11-23,85000000,46462469,149717124,64717124
xXx: Return of Xander Cage,15,2017-01-20,85000000,44898413,345033359,260033359
Cats & Dogs: The Revenge of Kitty Galore,17,2010-07-30,85000000,43585753,113026383,28026383
Collateral Damage,18,2002-02-08,85000000,40048332,78353508,-6646492
Showtime,19,2002-03-15,85000000,37948765,78948765,-6051235
Zodiac,21,2007-03-02,85000000,33080084,83080084,-1919916
Scott Pilgrim vs. The World,22,2010-08-13,85000000,31611316,48056764,-36943236
The Core,23,2003-03-28,85000000,31111260,74132631,-10867369
The Greatest Showman,25,2017-12-20,84000000,174340174,386665550,302665550
Scooby-Doo,26,2002-06-14,84000000,153294164,276294164,192294164
Nutty Professor II: The Klumps,27,2000-07-28,84000000,123307945,166307945,82307945
RED 2,28,2013-07-19,84000000,53262560,141507355,57507355
Click,29,2006-06-23,82500000,137355633,237685089,155185089
Charlotte's Web,30,2006-12-15,82500000,82985708,143985708,61485708
Jumper,31,2008-02-14,82500000,80172128,222640812,140140812
Hellboy II: The Golden Army,32,2008-07-11,82500000,75986503,160388063,77888063
The Longest Yard,33,2005-05-27,82000000,158119460,191558505,109558505
The Expendables,34,2010-08-13,82000000,103068524,268268174,186268174
The 6th Day,35,2000-11-17,82000000,34543701,96024898,14024898
Bruce Almighty,37,2003-05-23,81000000,242704995,484468608,403468608
The Hunger Games,38,2012-03-23,80000000,408010692,677923379,597923379
The Hangover Part II,39,2011-05-26,80000000,254464305,586464305,506464305
The Lego Batman Movie,41,2017-02-10,80000000,175750384,310660018,230660018
Hotel Transylvania 2,42,2015-09-25,80000000,169700110,469500298,389500298
Over the Hedge,45,2006-05-19,80000000,155019340,343397247,263397247
Lilo & Stitch,46,2002-06-21,80000000,145771527,245800000,165800000
Grown Ups 2,48,2013-07-12,80000000,133668525,247023808,167023808
Alvin and the Chipmunks: Chipwrecked,49,2011-12-16,80000000,133107389,349088523,269088523
Get Smart,50,2008-06-20,80000000,130319208,226739416,146739416
Robots,51,2005-03-11,80000000,128200012,260700012,180700012
Shutter Island,52,2010-02-19,80000000,128012934,299461782,219461782
Something's Gotta Give,53,2003-12-12,80000000,124685242,266685242,186685242
Four Christmases,54,2008-11-26,80000000,120146040,168311558,88311558
Bedtime Stories,56,2008-12-25,80000000,110101975,221468935,141468935
Road to Perdition,57,2002-07-12,80000000,104054514,183354514,103354514
Just Go With It,58,2011-02-11,80000000,103028109,214974953,134974953
Daredevil,59,2003-02-14,80000000,102543518,182782518,102782518
Eagle Eye,60,2008-09-26,80000000,101440743,180585259,100585259
Yogi Bear,62,2010-12-17,80000000,100246011,204774690,124774690
Cold Mountain,63,2003-12-25,80000000,95632614,165173909,85173909
The Book of Eli,64,2010-01-15,80000000,94835059,158750817,78750817
Fury,68,2014-10-17,80000000,85817906,210315681,130315681
Smallfoot,69,2018-09-28,80000000,83240103,213691277,133691277
The Pink Panther,70,2006-02-10,80000000,82226474,158926474,78926474
Zookeeper,71,2011-07-08,80000000,80360866,170805525,90805525
The Day the Earth Stood Still,72,2008-12-12,80000000,79366978,237370350,157370350
Spirit: Stallion of the Cimarron,75,2002-05-24,80000000,73215310,106515310,26515310
Swordfish,76,2001-06-08,80000000,69772969,147080413,67080413
The Manchurian Candidate,79,2004-07-30,80000000,65948711,96148711,16148711
DÃ©jÃ Vu,80,2006-11-22,80000000,64038616,181038616,101038616
Bewitched,82,2005-06-24,80000000,63313159,131159306,51159306
The Time Machine,83,2002-03-08,80000000,56684819,98983590,18983590
The Legend of Zorro,86,2005-10-28,80000000,45575336,141475336,61475336
Little Nicky,87,2000-11-10,80000000,39442871,58270391,-21729609
Surrogates,88,2009-09-25,80000000,38577772,119668350,39668350
Evolution,89,2001-06-08,80000000,38311134,98341932,18341932
The Brothers Grimm,90,2005-08-26,80000000,37899638,105299638,25299638
The Wild,92,2006-04-14,80000000,37384046,99010667,19010667
Walking with Dinosaurs,93,2013-12-20,80000000,36076121,123368842,43368842
Thirteen Days,94,2000-12-22,80000000,34566746,66554547,-13445453
The Last Witch Hunter,96,2015-10-23,80000000,27367660,130818912,50818912
Pompeii,97,2014-02-21,80000000,23169033,108469033,28469033
Battlefield Earth: A Saga of the Year 3000,98,2000-05-12,80000000,21471685,29725663,-50274337
Looney Tunes: Back in Action,99,2003-11-14,80000000,20950820,54540662,-25459338
Nine,100,2009-12-18,80000000,19676965,53508858,-26491142
Timeline,1,2003-11-26,80000000,19480739,26703184,-53296816
Oceans,2,2010-04-22,80000000,19422319,86787530,6787530
Red Planet,5,2000-11-10,80000000,17480890,33463969,-46536031
Arthur et les Minimoys,6,2007-01-12,80000000,15132763,113325743,33325743
The Invasion,7,2007-08-17,80000000,15074191,40147042,-39852958
A Sound of Thunder,8,2005-09-02,80000000,1900451,6300451,-73699549
Journey 2: The Mysterious Island,10,2012-02-10,79000000,103860290,318146162,239146162
Jack and Jill,11,2011-11-11,79000000,74158157,150519217,71519217
A Beautiful Mind,12,2001-12-21,78000000,170708996,317668058,239668058
Cloudy with a Chance of Meatballs 2,13,2013-09-27,78000000,119793567,274392649,196392649
Red Dragon,14,2002-10-04,78000000,92955420,206455420,128455420
Hidalgo,15,2004-03-05,78000000,67286731,108086731,30086731
The League of Extraordinary Gentlemen,16,2003-07-11,78000000,66465204,179265204,101265204
Exorcist: The Beginning,17,2004-08-20,78000000,41814863,43957541,-34042459
AstÃ©rix et ObÃ©lix: Au service de Sa MajestÃ©,18,2012-12-31,77600000,0,60680125,-16919875
The Little Prince,19,2016-02-12,77500000,1311213,102028919,24528919
The Equalizer 2,21,2018-07-20,77000000,102084362,190453132,113453132
Despicable Me 2,22,2013-07-03,76000000,368065385,975216835,899216835
2 Fast 2 Furious,23,2003-06-06,76000000,127120058,236410607,160410607
Children of Men,24,2006-12-25,76000000,35552383,69845011,-6154989
The Adventures of Rocky & Bullwinkle,25,2000-06-30,76000000,26000610,35129610,-40870390
The Secret Life of Pets,26,2016-07-08,75000000,368384330,886750534,811750534
Dr. Seussâ The Grinch,28,2018-11-09,75000000,270620950,511002426,436002426
Sing,29,2016-12-21,75000000,270329045,634454789,559454789
Despicable Me 3,30,2017-06-30,75000000,264624300,1034727750,959727750
Ice Age: The Meltdown,32,2006-03-31,75000000,195330621,651899282,576899282
Madagascar,33,2005-05-27,75000000,193595521,556559566,481559566
Grown Ups,34,2010-06-25,75000000,162001186,272223430,197223430
Shark Tale,35,2004-10-01,75000000,161412000,371917043,296917043
X-Men,36,2000-07-14,75000000,157299717,296872367,221872367
Wanted,37,2008-06-27,75000000,134508551,342416460,267416460
50 First Dates,39,2004-02-13,75000000,120776832,196320329,121320329
Hairspray,40,2007-07-20,75000000,118871849,203035572,128035572
Now You See Me,41,2013-05-31,75000000,117723989,342769200,267769200
Dreamgirls,42,2006-12-15,75000000,103365956,155708695,80708695
Christopher Robin,43,2018-08-03,75000000,99215042,197504758,122504758
Immortals,45,2011-11-11,75000000,83504017,211562435,136562435
The Terminal,46,2004-06-18,75000000,77073959,218673959,143673959
Constantine,47,2005-02-18,75000000,75976178,221594911,146594911
Monster House,48,2006-07-21,75000000,73661010,141267370,66267370
Vertical Limit,49,2000-12-08,75000000,68473360,213500000,138500000
Charlie Wilson's War,50,2007-12-21,75000000,66661095,119512771,44512771
Be Cool,52,2005-03-04,75000000,55849401,94944017,19944017
Munich,53,2005-12-23,75000000,47379090,131492772,56492772
Killers,54,2010-06-04,75000000,47059963,95572749,20572749
The Man From U.N.C.L.E.,55,2015-08-14,75000000,45445109,104949584,29949584
Tears of the Sun,56,2003-03-07,75000000,43632458,85632458,10632458
Lady in the Water,57,2006-07-21,75000000,42285169,72785169,-2214831
Spanglish,58,2004-12-17,75000000,42044321,54344321,-20655679
Bandits,59,2001-10-12,75000000,41523271,71523271,-3476729
Sucker Punch,62,2011-03-25,75000000,36392502,89758389,14758389
Hostage,63,2005-03-11,75000000,34636443,77636443,2636443
Inferno,64,2016-10-28,75000000,34343574,219519367,144519367
Hollywood Homicide,65,2003-06-13,75000000,30207785,50409753,-24590247
Titan A.E.,66,2000-06-16,75000000,22751979,36751979,-38248021
Flight of the Phoenix,67,2004-12-17,75000000,21009180,34009180,-40990820
Monkeybone,70,2001-02-23,75000000,5409517,5409517,-69590483
Minions,73,2015-07-10,74000000,336045770,1160336173,1086336173
The SpongeBob Movie: Sponge Out of Water,74,2015-02-06,74000000,162994032,311013181,237013181
Unbreakable,75,2000-11-22,73243106,94999143,248099143,174856037
Talladega Nights: The Ballad of Ricky Bobby,76,2006-08-04,73000000,148213377,162870525,89870525
The Angry Birds Movie,77,2016-05-20,73000000,107509366,352327887,279327887
The Simpsons Movie,80,2007-07-27,72500000,183135014,527071022,454571022
Fool's Gold,81,2008-02-08,72500000,70231041,109362966,36862966
Funny People,82,2009-07-31,72500000,51855045,71880305,-619695
The Kingdom,83,2007-09-28,72500000,47467250,86509602,14009602
Dr. Dolittle 2,84,2001-06-22,72000000,112950721,176101721,104101721
Jarhead,86,2005-11-04,72000000,62647540,96947540,24947540
Driven,87,2001-04-27,72000000,32616869,54616869,-17383131
The Majestic,88,2001-12-21,72000000,27796042,37306334,-34693666
Two Brothers,89,2004-06-25,72000000,19176754,62176754,-9823246
The Village,90,2004-07-30,71682975,114197520,257641634,185958659
Signs,92,2002-08-02,70702619,227969295,408269295,337566676
Shrek 2,93,2004-05-19,70000000,441226247,937008132,867008132
Cars,94,2006-06-09,70000000,244082982,461651246,391651246
Alvin and the Chipmunks: The Squeakquel,95,2009-12-23,70000000,219614612,443483213,373483213
xXx,98,2002-08-09,70000000,141930000,267200000,197200000
Oceanâs 8,99,2018-06-08,70000000,140218711,297115976,227115976
Inglourious Basterds,1,2009-08-21,70000000,120774594,316915264,246915264
S.W.A.T.,4,2003-08-08,70000000,116877597,207154748,137154748
Daddyâs Home 2,5,2017-11-10,70000000,104029443,175807183,105807183
Vanilla Sky,7,2001-12-14,70000000,100614858,202726605,132726605
Olympus Has Fallen,9,2013-03-22,70000000,98927592,172878928,102878928
Battle: Los Angeles,10,2011-03-11,70000000,83552429,213463976,143463976
AVP: Alien Vs. Predator,11,2004-08-13,70000000,80281096,172543519,102543519
War Horse,12,2011-12-25,70000000,79883359,156815529,86815529
We Were Soldiers,13,2002-03-01,70000000,78120196,114658262,44658262
The Monuments Men,14,2014-02-07,70000000,78031620,158702748,88702748
Storks,15,2016-09-23,70000000,72679278,183353431,113353431
Big Fish,17,2003-12-10,70000000,66432867,123954323,53954323
Underworld: Awakening,19,2012-01-20,70000000,62321039,160379930,90379930
The Lego Ninjago Movie,20,2017-09-22,70000000,59281555,122737201,52737201
Dracula Untold,21,2014-10-10,70000000,55991880,220241723,150241723
The Guardian,22,2006-09-29,70000000,55011732,94973540,24973540
Wall Street 2: Money Never Sleeps,24,2010-09-24,70000000,52474616,137431619,67431619
The Dilemma,25,2011-01-14,70000000,48475290,70546865,546865
Rumor Has It,26,2005-12-25,70000000,42996140,88933562,18933562
Stardust,28,2007-08-10,70000000,38634938,137022245,67022245
Rock of Ages,29,2012-06-15,70000000,38518613,61031932,-8968068
Sky Captain and the World of Tomorrow,31,2004-09-17,70000000,37760080,49730854,-20269146
The Brave One,32,2007-09-14,70000000,36793804,69792704,-207296
I Spy,33,2002-11-01,70000000,33561137,60279822,-9720178
Bad Company,34,2002-06-07,70000000,30157016,69157016,-842984
Doom,35,2005-10-21,70000000,28212337,58757178,-11242822
The Finest Hours,36,2016-01-29,70000000,27569558,49252761,-20747239
Escape Plan,37,2013-10-18,70000000,25135965,103735965,33735965
Killer Elite,38,2011-09-23,70000000,25124986,65409046,-4590954
Hart's War,40,2002-02-15,70000000,19076815,33076815,-36923185
Rollerball,41,2002-02-08,70000000,18990542,25852508,-44147492
The Legend of Hercules,42,2014-01-10,70000000,18848538,58953319,-11046681
Next,43,2007-04-27,70000000,18211013,73591500,3591500
Ballistic: Ecks vs. Sever,44,2002-09-20,70000000,14294842,14294842,-55705158
Osmosis Jones,45,2001-08-10,70000000,13596911,13596911,-56403089
Legends of Oz: Dorothyâs Return,46,2014-05-09,70000000,8462347,20107933,-49892067
Blackhat,47,2015-01-16,70000000,8005980,19665004,-50334996
Basic Instinct 2,48,2006-03-31,70000000,5946136,35417162,-34582838
Agora,49,2010-05-28,70000000,619423,38992292,-31007708
Despicable Me,50,2010-07-09,69000000,251513985,543464573,474464573
Dinner for Schmucks,51,2010-07-30,69000000,73026337,86796502,17796502
Red Sparrow,52,2018-03-02,69000000,46874505,145951861,76951861
The Twilight Saga: Eclipse,53,2010-06-30,68000000,300531751,706102828,638102828
The Sum of All Fears,54,2002-05-31,68000000,118471320,193500000,125500000
Ted 2,55,2015-06-26,68000000,81476385,217214143,149214143
The Score,56,2001-07-13,68000000,71069884,113542091,45542091
Hall Pass,57,2011-02-25,68000000,45060734,87173475,19173475
Dreamcatcher,59,2003-03-21,68000000,33685268,75685268,7685268
Downsizing,62,2017-12-22,68000000,24449754,54462971,-13537029
Doctor Seuss' The Lorax,63,2012-03-02,67500000,214030500,350976753,283476753
Body of Lies,64,2008-10-10,67500000,39394666,118556530,51056530
Abraham Lincoln: Vampire Hunter,65,2012-06-22,67500000,37519139,137489730,69989730
The Last Legion,67,2007-08-17,67000000,5932060,25357771,-41642229
Need for Speed,70,2014-03-14,66000000,43568507,194169619,128169619
What Women Want,72,2000-12-15,65000000,182805123,374105123,309105123
Lincoln,73,2012-11-09,65000000,182207973,273346281,208346281
Ice Age,74,2002-03-15,65000000,176387405,386116343,321116343
Hotel Transylvania 3: Summer Vacation,77,2018-07-13,65000000,167500092,527079962,462079962
Les Miserables,78,2012-12-25,65000000,148809770,442169052,377169052
The Santa Clause 2,79,2002-11-01,65000000,139225854,172825854,107825854
Unbroken,82,2014-12-25,65000000,115637895,163527824,98527824
Spy!,83,2015-06-05,65000000,110825712,232585748,167585748
Due Date,84,2010-11-05,65000000,100539043,211739043,146739043
Step Brothers,85,2008-07-25,65000000,100468793,128468793,63468793
Space Cowboys,88,2000-08-04,65000000,90454043,128874043,63874043
Annie,89,2014-12-19,65000000,85911262,139829625,74829625
Peteâs Dragon,91,2016-08-12,65000000,76233151,137768975,72768975
World Trade Center,93,2006-08-09,65000000,70278893,163295654,98295654
The Kid,94,2000-07-07,65000000,69688384,69688384,4688384
Mona Lisa Smile,95,2003-12-19,65000000,63803100,141205169,76205169
The Dictator,96,2012-05-16,65000000,59650222,180148897,115148897
This Means War,98,2012-02-17,65000000,54760791,156974557,91974557
Focus,99,2015-02-27,65000000,53862963,168065700,103065700
Blade: Trinity,100,2004-12-08,65000000,52397389,131353165,66353165
Red Dawn,1,2012-11-21,65000000,44806783,48164150,-16835850
We Are Marshall,2,2006-12-22,65000000,43545364,43545364,-21454636
Everest,3,2015-09-18,65000000,43482270,221297061,156297061
Resident Evil: Retribution,4,2012-09-14,65000000,42345531,240647629,175647629
Death Race,7,2008-08-22,65000000,36316032,72516819,7516819
Proof of Life,9,2000-12-08,65000000,32598931,62761005,-2238995
Zathura,10,2005-11-11,65000000,28045540,58545540,-6454460
The Missing,11,2003-11-26,65000000,26900336,38253433,-26746567
Elektra,12,2005-01-14,65000000,24409722,56824633,-8175367
Astro Boy,13,2009-10-23,65000000,19551067,41636243,-23363757
"I, Frankenstein",14,2014-01-24,65000000,19075290,74575290,9575290
Sin City: A Dame to Kill For,16,2014-08-22,65000000,13757804,40650842,-24349158
Live by Night,17,2016-12-25,65000000,10378555,21774432,-43225568
Lucky Numbers,18,2000-10-27,65000000,10014234,10014234,-54985766
Oliver Twist,19,2005-09-23,65000000,2070920,26670920,-38329080
Tian jiang xiong shi,20,2015-09-04,65000000,74070,122519874,57519874
Air Strike,21,2018-10-26,65000000,0,516279,-64483721
Little Man,22,2006-07-14,64000000,58636047,101636047,37636047
Perfume: The Story of a Murderer,24,2006-12-27,63700000,2223293,133603463,69903463
Austin Powers in Goldmember,26,2002-07-25,63000000,213117789,296338663,233338663
Hop,27,2011-04-01,63000000,108085305,188657593,125657593
American Assassin,28,2017-09-15,63000000,36249674,68310140,5310140
U-571,31,2000-04-21,62000000,77086030,127630030,65630030
The Hateful Eight,33,2015-12-25,62000000,54117416,147864886,85864886
The Love Guru,34,2008-06-20,62000000,32235793,40159017,-21840983
3000 Miles to Graceland,35,2001-02-23,62000000,15738632,18708848,-43291152
Gone Girl,36,2014-10-03,61000000,167767189,368567189,307567189
Blades of Glory,37,2007-03-30,61000000,118594548,145594548,84594548
Maze Runner: The Scorch Trials,38,2015-09-18,61000000,81697192,310566162,249566162
2 Guns,39,2013-08-02,61000000,75612460,132493015,71493015
Maze Runner: The Death Cure,40,2018-01-26,61000000,58032443,265878536,204878536
Mei Ren Yu,42,2016-02-19,60720000,3229457,554516671,493796671
Meet the Fockers,43,2004-12-22,60000000,279167575,516567575,456567575
The Lego Movie,44,2014-02-07,60000000,257784718,457729388,397729388
300,45,2007-03-09,60000000,210614939,454161935,394161935
Wild Hogs,46,2007-03-02,60000000,168213584,253555383,193555383
Marley & Me,47,2008-12-25,60000000,143153751,247812011,187812011
Sully,50,2016-09-09,60000000,125070033,238524556,178524556
The Bourne Identity,51,2002-06-14,60000000,121468960,214357371,154357371
Couples Retreat,52,2009-10-09,60000000,109205660,172450423,112450423
The Italian Job,54,2003-05-30,60000000,106126012,176262839,116262839
Daddy Day Care,55,2003-05-09,60000000,104148781,164285587,104285587
Collateral,58,2004-08-06,60000000,100170152,217670152,157670152
Cats & Dogs,59,2001-07-04,60000000,93375151,200700000,140700000
Two Weeks Notice,60,2002-12-20,60000000,93354918,199043309,139043309
The Scorpion King,62,2002-04-19,60000000,90580000,165890634,105890634
Red,63,2010-10-15,60000000,90380162,196439693,136439693
Starsky & Hutch,64,2004-03-05,60000000,88200225,170200225,110200225
Cheaper by the Dozen 2,66,2005-12-21,60000000,82571173,135015330,75015330
Eat Pray Love,67,2010-08-13,60000000,80574010,206598789,146598789
Jack Reacher,68,2012-12-21,60000000,80070736,217370736,157370736
Man on Fire,69,2004-04-23,60000000,77906816,130968579,70968579
The Family Man,70,2000-12-22,60000000,75764085,124715863,64715863
Contagion,71,2011-09-09,60000000,75658097,137551594,77551594
Coraline,74,2009-02-06,60000000,75286229,126037057,66037057
Ladder 49,75,2004-10-01,60000000,74541707,102332848,42332848
Michael Jackson's This Is It,77,2009-10-28,60000000,72091016,252091016,192091016
Kangaroo Jack,78,2003-01-17,60000000,66723216,90723216,30723216
The Happening,79,2008-06-13,60000000,64506874,162778384,102778384
London Has Fallen,80,2016-03-04,60000000,62524260,195194085,135194085
Rules of Engagement,81,2000-04-07,60000000,61322858,71719931,11719931
The Shaggy Dog,82,2006-03-10,60000000,61123569,87123569,27123569
Hellboy,84,2004-04-02,60000000,59623958,99823958,39823958
Jack Reacher: Never Go Back,85,2016-10-21,60000000,58697076,159946489,99946489
Baywatch,86,2017-05-25,60000000,58060186,175863783,115863783
Joy,88,2015-12-25,60000000,56451232,101134059,41134059
ParaNorman,89,2012-08-17,60000000,56003051,108119662,48119662
Paycheck,91,2003-12-25,60000000,53789313,98819789,38819789
The Tale of Despereaux,93,2008-12-19,60000000,50877145,90482317,30482317
The Boxtrolls,94,2014-09-26,60000000,50837305,111946251,51946251
The Dark Tower,95,2017-08-04,60000000,50701325,113461527,53461527
The Tuxedo,96,2002-09-27,60000000,50586000,104429625,44429625
Jack Ryan: Shadow Recruit,97,2014-01-17,60000000,50577412,131377412,71377412
Miss Congeniality 2: Armed and Fabulous,99,2005-03-24,60000000,48478006,101382396,41382396
Vice,100,2018-12-25,60000000,47836282,70883171,10883171
Shooter,2,2007-03-23,60000000,47003582,95538560,35538560
Gangster Squad,4,2013-01-11,60000000,46000903,104100903,44100903
Smurfs: The Lost Village,5,2017-04-07,60000000,45020282,197578586,137578586
First Man,6,2018-10-12,60000000,44936545,105203825,45203825
Year One,7,2009-06-19,60000000,43337279,57604723,-2395277
Edge of Darkness,8,2010-01-29,60000000,43313890,82812456,22812456
Star Trek: Nemesis,9,2002-12-13,60000000,43254409,67312826,7312826
Reign of Fire,10,2002-02-19,60000000,43061982,82150183,22150183
Planet 51,11,2009-11-20,60000000,42194060,108996113,48996113
Duplicity,12,2009-03-20,60000000,40572825,81079566,21079566
Righteous Kill,13,2008-09-12,60000000,40081410,78481410,18481410
Invictus,14,2009-12-11,60000000,37491364,124514011,64514011
State of Play,15,2009-04-17,60000000,37017955,88832210,28832210
The Sentinel,17,2006-04-21,60000000,36280697,78080697,18080697
Trouble with the Curve,18,2012-09-21,60000000,35763137,47818913,-12181087
Intolerable Cruelty,19,2003-10-10,60000000,35327628,121327628,61327628
Almost Famous,22,2000-09-15,60000000,32522352,47371191,-12628809
Analyze That,24,2002-12-06,60000000,32122249,54994757,-5005243
The Soloist,25,2009-04-24,60000000,31853584,38522450,-21477550
The Mortal Instruments: City of Bones,26,2013-08-21,60000000,31165421,75965567,15965567
The Legend of Bagger Vance,27,2000-11-03,60000000,30695227,39235486,-20764514
Dragonfly,28,2002-02-22,60000000,30063805,30063805,-29936195
Priest,29,2011-05-13,60000000,29136626,84154026,24154026
Garfield: A Tail of Two Kitties,30,2006-06-16,60000000,28426747,147985373,87985373
XXX: State of the Union,31,2005-04-29,60000000,26873932,71073932,11073932
Sinbad: Legend of the Seven Seas,33,2003-07-02,60000000,26483452,80767884,20767884
Dark Water,34,2005-07-08,60000000,25473093,49473093,-10526907
The Black Dahlia,36,2006-09-15,60000000,22672813,49238525,-10761475
The Spirit,38,2008-12-25,60000000,19806188,39006188,-20993812
The Last Castle,39,2001-10-19,60000000,18208078,20541668,-39458332
Inkheart,40,2009-01-23,60000000,17303424,66655938,6655938
Supernova,41,2000-01-14,60000000,14218868,14816494,-45183506
Flyboys,42,2006-09-22,60000000,13090630,14816379,-45183621
Winterâs Tale,43,2014-02-14,60000000,12600231,29575033,-30424967
Meet Dave,45,2008-07-11,60000000,11803254,50648806,-9351194
The Great Raid,46,2005-08-12,60000000,10166502,10597070,-49402930
Rock Dog,47,2017-02-24,60000000,9420546,24148488,-35851512
Mortdecai,48,2015-01-23,60000000,7696134,30396134,-29603866
In the Name of the King: A Dungeon Siege Tale,49,2008-01-11,60000000,4775656,13233220,-46766780
Beyond Borders,50,2003-10-24,60000000,4426297,11427090,-48572910
Xi You Ji zhi Sun Wu Kong San Da Bai Gu Jing,51,2016-02-05,60000000,709982,194058503,134058503
The Ridiculous 6,52,2015-12-11,60000000,0,0,-60000000
Sherlock Gnomes,54,2018-03-23,59000000,43242871,87527651,28527651
Deadpool,56,2016-02-12,58000000,363070709,801025593,743025593
American Sniper,57,2014-12-25,58000000,350126372,547326372,489326372
Goosebumps,58,2015-10-16,58000000,80069458,158905324,100905324
Red Tails,61,2012-01-20,58000000,49876377,50365498,-7634502
Just Like Heaven,62,2005-09-16,58000000,48318130,100687083,42687083
The Internship,63,2013-06-07,58000000,44672764,93672764,35672764
The Flintstones in Viva Rock Vegas,64,2000-04-28,58000000,35231365,59431365,1431365
Leatherheads,65,2008-04-04,58000000,31373938,41348628,-16651372
Life,66,2017-03-24,58000000,30234022,100929666,42929666
Did You Hear About the Morgans?,67,2009-12-18,58000000,29580087,80480566,22480566
"Che, Part 1: The Argentine",68,2008-12-12,58000000,1802521,31627370,-26372630
Sex and the City,69,2008-05-30,57500000,152647258,415247258,357747258
Resident Evil: Afterlife,70,2010-09-10,57500000,60128566,295874190,238374190
That's My Boy,71,2012-06-15,57500000,36931089,58085235,585235
Ghost Rider: Spirit of Vengeance,73,2012-02-17,57000000,51774002,149217355,92217355
After the Sunset,75,2004-11-12,57000000,28328132,38329114,-18670886
Captain Corelli's Mandolin,76,2001-08-17,57000000,25528495,62097495,5097495
Into the Woods,77,2014-12-25,56200000,128002372,213116401,156916401
Anger Management,78,2003-04-11,56000000,135560942,195660942,139660942
The Pacifier,79,2005-03-04,56000000,113006880,198006880,142006880
Walking Tall,80,2004-04-02,56000000,46213824,47313824,-8686176
Zhuo yao ji,81,2016-01-22,56000000,32766,359495591,303495591
Alvin and the Chipmunks,83,2007-12-14,55000000,217326974,362605033,307605033
Bohemian Rhapsody,84,2018-11-02,55000000,216303339,894985342,839985342
Hitch,85,2005-02-11,55000000,177784257,366784257,311784257
Meet the Parents,86,2000-10-06,55000000,166225040,330425040,275425040
The Pursuit of Happyness,87,2006-12-15,55000000,162586036,307311093,252311093
Fifty Shades Darker,91,2017-02-10,55000000,114434010,381398492,326398492
Captain Phillips,92,2013-10-11,55000000,107136417,220648184,165648184
American Wedding,94,2003-08-01,55000000,104354205,126425115,71425115
Murder on the Orient Express,95,2017-11-10,55000000,102826543,345922730,290922730
The Equalizer,96,2014-09-26,55000000,101530738,192903624,137903624
Fifty Shades Freed,97,2018-02-09,55000000,100407760,371350619,316350619
Date Night,99,2010-04-09,55000000,98711404,152269033,97269033
Maid in Manhattan,100,2002-12-13,55000000,93932896,163838217,108838217
Flightplan,2,2005-09-23,55000000,89706988,214392904,159392904
Paddington,5,2015-01-16,55000000,76223578,258789097,203789097
R.V.,6,2006-04-28,55000000,71724497,87473024,32473024
Kill Bill: Volume 1,8,2003-10-10,55000000,70098138,176469428,121469428
Mr. Poppers's Penguins,9,2011-06-17,55000000,68224452,189624452,134624452
Kill Bill: Volume 2,11,2004-04-16,55000000,66207920,153535982,98535982
Shanghai Noon,14,2000-05-26,55000000,56932305,71189835,16189835
Free Birds,16,2013-11-01,55000000,55750480,110387072,55387072
The Forbidden Kingdom,18,2008-04-18,55000000,52075270,129075270,74075270
The Phantom of the Opera,19,2004-12-22,55000000,51225796,153770052,98770052
Muppets Most Wanted,20,2014-03-21,55000000,51178893,79312301,24312301
Kubo and the Two Strings,22,2016-08-19,55000000,48023088,77548122,22548122
Burlesque,24,2010-11-24,55000000,39440655,90552675,35552675
Changeling,26,2008-10-24,55000000,35739802,113805580,58805580
The Watch,27,2012-07-27,55000000,34353000,67130045,12130045
The Hunted,28,2003-03-14,55000000,34234008,47213095,-7786905
Stuck On You,30,2003-12-12,55000000,33832741,63537164,8537164
Semi-Pro,31,2008-02-29,55000000,33479698,43980363,-11019637
Annihilation,32,2018-02-23,55000000,32732301,43070915,-11929085
Crimson Peak,33,2015-10-16,55000000,31090320,74966854,19966854
The Pirates! Band of Misfits,34,2012-04-27,55000000,31051126,136143605,81143605
Aeon Flux,35,2005-12-02,55000000,25857987,53913573,-1086427
Elizabeth: The Golden Age,38,2007-10-12,55000000,16285240,74870866,19870866
Imagine That,39,2009-06-12,55000000,16222392,22438144,-32561856
Gods and Generals,40,2003-02-21,55000000,12882934,12923936,-42076064
Bullet to the Head,42,2013-02-01,55000000,9489829,22597969,-32402031
All the King's Men,43,2006-09-22,55000000,7221458,9521458,-45478542
Thunderbirds,44,2004-07-30,55000000,6768055,28231444,-26768556
Un long dimanche de fianÃ§ailles,45,2004-11-26,55000000,6167817,69759296,14759296
Lucky You,46,2007-05-04,55000000,5755286,6521829,-48478171
Eye See You,48,2002-09-20,55000000,79161,1807990,-53192010
Blade 2,50,2002-03-22,54000000,81676888,154338601,100338601
"You, Me and Dupree",51,2006-07-14,54000000,75802010,130402010,76402010
Seven Pounds,52,2008-12-19,54000000,69951824,166617328,112617328
Elizabethtown,54,2005-10-14,54000000,26850426,50719373,-3280627
Gigli,55,2003-08-01,54000000,6087542,7126002,-46873998
Shaft,56,2000-06-16,53012938,70327868,107190108,54177170
The Dukes of Hazzard,57,2005-08-05,53000000,80270227,109848461,56848461
Law Abiding Citizen,58,2009-10-16,53000000,73357727,131159781,78159781
Black Mass,59,2015-09-18,53000000,62575678,98837872,45837872
Moulin Rouge,61,2001-05-18,53000000,57386369,179200588,126200588
Domestic Disturbance,62,2001-11-02,53000000,45207112,54207112,1207112
Flags of Our Fathers,63,2006-10-20,53000000,33602376,63657941,10657941
Grindhouse,64,2007-04-06,53000000,25031037,50187789,-2812211
Zero Dark Thirty,66,2012-12-19,52500000,95720716,134612435,82112435
Catch Me if You Can,67,2002-12-25,52000000,164606800,355612291,303612291
Mamma Mia!,68,2008-07-18,52000000,144130063,615748772,563748772
The Break-Up,69,2006-06-02,52000000,118703275,205727307,153727307
Valentine's Day,70,2010-02-12,52000000,110485654,217569328,165569328
The Change-Up,72,2011-08-05,52000000,37243418,75997067,23997067
From Paris With Love,75,2010-02-05,52000000,24077427,53139168,1139168
Bulletproof Monk,76,2003-04-16,52000000,23010607,23010607,-28989393
"Me, Myself & Irene",77,2000-06-23,51000000,90570999,149270999,98270999
Barnyard: The Original Party Animals,78,2006-08-04,51000000,72779000,118583844,67583844
Alpha,79,2018-08-17,51000000,35851379,99624873,48624873
Deck the Halls,80,2006-11-22,51000000,35093569,46815807,-4184193
The Adjustment Bureau,81,2011-03-04,50200000,62495645,126931325,76731325
The Twilight Saga: New Moon,82,2009-11-20,50000000,296623634,687557727,637557727
Shrek,83,2001-05-18,50000000,267655011,491812794,441812794
Ted,84,2012-06-29,50000000,218665740,556016627,506016627
22 Jump Street,85,2014-06-13,50000000,191719337,331333876,281333876
Daddyâs Home,88,2015-12-25,50000000,150357137,242757137,192757137
Central Intelligence,91,2016-06-17,50000000,127440871,217194805,167194805
Anchorman 2: The Legend Continues,92,2013-12-18,50000000,127352707,172185754,122185754
Super 8,93,2011-06-10,50000000,127004179,257972745,207972745
Mr. Deeds,94,2002-06-28,50000000,126293452,171269535,121269535
Erin Brockovich,95,2000-03-17,50000000,125548685,257805243,207805243
Creed II,96,2018-11-21,50000000,115715889,213591522,163591522
Peter Rabbit,97,2018-02-09,50000000,115234093,347136477,297136477
How to Lose a Guy in 10 Days,98,2003-02-07,50000000,105807520,178890782,128890782
The Mule,100,2018-12-14,50000000,103804407,170857676,120857676
Yes Man,1,2008-12-19,50000000,97690976,225990976,175990976
Non-Stop,2,2014-02-28,50000000,91742160,222383055,172383055
Disney Planes,4,2013-08-09,50000000,90282580,238059569,188059569
Failure to Launch,5,2006-03-10,50000000,88715192,128402901,78402901
Inside Man,6,2006-03-24,50000000,88634237,185798265,135798265
The Emoji Movie,7,2017-07-28,50000000,86089513,216562312,166562312
"Crazy, Stupid, Love",8,2011-07-29,50000000,84351197,147142328,97142328
The Post,9,2017-12-22,50000000,81903458,179748880,129748880
Knowing,12,2009-03-20,50000000,79957634,186450317,136450317
The Ring Two,13,2005-03-18,50000000,75941727,161941727,111941727
We Bought a Zoo,14,2011-12-23,50000000,75624550,118729073,68729073
Moneyball,15,2011-09-23,50000000,75605492,111300835,61300835
Garfield: The Movie,16,2004-06-11,50000000,75367693,208094550,158094550
Christmas with the Kranks,17,2004-11-24,50000000,73701902,96469187,46469187
V for Vendetta,18,2006-03-17,50000000,70511035,130214162,80214162
Race to Witch Mountain,20,2009-03-13,50000000,67172595,105103784,55103784
The Forgotten,21,2004-09-24,50000000,66711892,117211892,67211892
Herbie: Fully Loaded,22,2005-06-22,50000000,66010682,144110682,94110682
Shanghai Knights,23,2003-02-07,50000000,60470220,88316835,38316835
Planes: Fire and Rescue,24,2014-07-18,50000000,59157732,156399644,106399644
Curious George,25,2006-02-10,50000000,58640119,71052604,21052604
American Reunion,26,2012-04-06,50000000,56758835,236799211,186799211
Hansel & Gretel: Witch Hunters,27,2013-01-25,50000000,55703475,214949716,164949716
I am Number Four,28,2011-02-18,50000000,55100437,146195159,96195159
Donât Say a Word,29,2001-09-28,50000000,54997476,104488383,54488383
13 Hours: The Secret Soldiers of Benghazi,30,2016-01-15,50000000,52853219,69411370,19411370
Unfaithful,31,2002-05-08,50000000,52752475,119114494,69114494
American Made,32,2017-09-29,50000000,51342000,135569212,85569212
Syriana,33,2005-11-23,50000000,50824620,92690959,42690959
Resident Evil: Apocalypse,34,2004-09-10,50000000,50740078,125168734,75168734
The Book of Life,35,2014-10-17,50000000,50151543,97651543,47651543
Firewall,37,2006-02-10,50000000,48751189,82751189,32751189
Into the Storm,40,2014-08-08,50000000,47602194,150429371,100429371
The Judge,41,2014-10-10,50000000,47119388,76119388,26119388
Silent Hill,42,2006-04-21,50000000,46982632,94704227,44704227
The Replacements,43,2000-08-11,50000000,44737059,50054511,54511
War Dogs,45,2016-08-19,50000000,43034523,86234503,36234503
Out of Time,49,2003-10-03,50000000,41083108,55489826,5489826
Bridget Jones: The Edge Of Reason,50,2004-11-12,50000000,40203020,263894551,213894551
The Beach,51,2000-02-11,50000000,39778599,39778599,-10221401
The Adventures of Sharkboy and Lavagirl in 3-D,52,2005-06-10,50000000,39177684,69425966,19425966
Ninja Assassin,54,2009-11-25,50000000,38122883,62209892,12209892
Raising Helen,55,2004-05-28,50000000,37485528,49928680,-71320
The Nice Guys,56,2016-05-20,50000000,36261763,59596747,9596747
Marmaduke,59,2010-06-04,50000000,33644788,89895930,39895930
Hereafter,61,2010-10-15,50000000,32746941,108660270,58660270
Murder by Numbers,62,2002-04-19,50000000,31874869,56643267,6643267
Zoolander 2,64,2016-02-12,50000000,28848693,55348693,5348693
Defiance,65,2009-01-16,50000000,28644813,52987754,2987754
Hannibal Rising,66,2007-02-09,50000000,27669725,80583311,30583311
The Host,68,2013-03-29,50000000,26623701,64477051,14477051
Basic,69,2003-03-28,50000000,26599248,42598498,-7401502
Run All Night,70,2015-03-13,50000000,26461644,66961644,16961644
Blood Work,71,2002-08-09,50000000,26199517,26199517,-23800483
The International,72,2009-02-13,50000000,25450527,53850527,3850527
Twisted,74,2004-02-27,50000000,25195050,40119848,-9880152
The Life Aquatic with Steve Zissou,75,2004-12-10,50000000,24006726,34806726,-15193274
Your Highness,78,2011-04-08,50000000,21596445,26121638,-23878362
Snowden,79,2016-09-16,50000000,21587519,35380918,-14619082
Dream House,80,2011-09-30,50000000,21302340,41642166,-8357834
Free State of Jones,81,2016-06-24,50000000,20810036,23237252,-26762748
Gamer,82,2009-09-04,50000000,20534907,42002029,-7997971
Man of the House,83,2005-02-25,50000000,19699706,22099706,-27900294
The Life of David Gale,84,2003-02-21,50000000,19694635,28920188,-21079812
Beautiful Creatures,85,2013-02-14,50000000,19452138,60282876,10282876
Into the Blue,86,2005-09-30,50000000,18782227,41982227,-8017773
Eastern Promises,87,2007-09-14,50000000,17181265,56077088,6077088
Drive Angry,91,2011-02-25,50000000,10721033,41042583,-8957417
Domino,94,2005-10-14,50000000,10169202,23574057,-26425943
Street Fighter: The Legend of Chun-Li,96,2009-02-27,50000000,8742261,12660287,-37339713
Death to Smoochy,97,2002-03-29,50000000,8355815,8374062,-41625938
Early Man,98,2018-02-16,50000000,8267544,45285890,-4714110
The Boat That Rocked,99,2009-11-13,50000000,8017467,37472651,-12527349
The Big Bounce,100,2004-01-30,50000000,6471394,6626115,-43373885
What Planet Are You From?,1,2000-03-03,50000000,6291602,6291602,-43708398
Child 44,2,2015-04-17,50000000,1224330,8004221,-41995779
Outlander,3,2009-01-23,50000000,166003,1250617,-48749383
Upside Down,4,2013-03-15,50000000,102118,26387039,-23612961
Shanghai,5,2015-10-02,50000000,46425,15505922,-34494078
The One,10,2001-11-02,49000000,43905746,72689126,23689126
Chappie,11,2015-03-06,49000000,31569268,105002056,56002056
Anna Karenina,13,2012-11-16,49000000,12816367,71004627,22004627
The Ring,15,2002-10-18,48000000,129094024,248218486,200218486
Traffic,16,2000-12-27,48000000,124107476,208300000,160300000
Panic Room,17,2002-03-29,48000000,95308367,196308367,148308367
Taken 3,18,2015-01-09,48000000,89256424,327656424,279656424
Instant Family,20,2018-11-16,48000000,67363237,119736188,71736188
Tooth Fairy,23,2010-01-22,48000000,60022256,112610386,64610386
Rat Race,24,2001-08-17,48000000,56607223,86607223,38607223
3:10 to Yuma,25,2007-09-07,48000000,53606916,71171825,23171825
K-PAX,26,2001-08-13,48000000,50315140,50315140,2315140
Kate and Leopold,27,2001-12-25,48000000,47095453,70937778,22937778
Bedazzled,28,2000-10-20,48000000,37879996,90376224,42376224
Rambo,31,2008-01-25,47500000,42754105,112214531,64714531
The Infiltrator,32,2016-07-13,47500000,15436808,20718104,-26781896
Arrival,34,2016-11-11,47000000,100546139,203127894,156127894
Earth,36,2009-04-22,47000000,32011576,116773317,69773317
Riding in Cars with Boys,37,2001-10-19,47000000,29781453,29781453,-17218547
Happily N'Ever After,38,2007-01-05,47000000,15849032,37923818,-9076182
Solaris,39,2002-11-27,47000000,14970038,14970038,-32029962
Jonah Hex,40,2010-06-18,47000000,10547117,11022696,-35977304
Silence,42,2016-12-23,46500000,7100177,23726626,-22773374
Mr. Nobody,43,2013-11-01,46500000,3622,22254,-46477746
America's Sweethearts,45,2001-07-20,46000000,93607673,160648493,114648493
Insomnia,47,2002-05-24,46000000,67263182,113622499,67622499
Prisoners,48,2013-09-20,46000000,61002302,113402302,67402302
Arthur and the War of Two Worlds,51,2010-12-31,45500000,347136,36180824,-9319176
Taken 2,54,2012-10-05,45000000,139854287,377807404,332807404
Scary Movie 3,56,2003-10-24,45000000,110000082,155200000,110200000
Miss Congeniality,57,2000-12-22,45000000,106807667,213420951,168420951
Pitch Perfect 3,58,2017-12-22,45000000,104897530,185736412,140736412
Journey to the Center of the Earth,59,2008-07-11,45000000,101704370,243180937,198180937
The Princess Diaries 2: Royal Engagement,61,2004-08-11,45000000,95149435,122071435,77071435
The Bucket List,62,2007-12-25,45000000,93466502,174807445,129807445
The Muppets,64,2011-11-23,45000000,88625922,160971922,115971922
Monster-in-Law,66,2005-05-13,45000000,82931301,155931301,110931301
Training Day,67,2001-10-05,45000000,76261036,104505362,59505362
The Girl on the Train,68,2016-10-07,45000000,75395035,174278214,129278214
Scary Movie 2,70,2001-07-04,45000000,71277420,141189101,96189101
Coach Carter,72,2005-01-14,45000000,67264877,76665507,31665507
The Bounty Hunter,73,2010-03-19,45000000,67061228,135808837,90808837
Changing Lanes,74,2002-04-12,45000000,66790248,66790248,21790248
Underworld: Evolution,76,2006-01-20,45000000,62318875,113417762,68417762
Coyote Ugly,77,2000-08-04,45000000,60786269,113916474,68916474
Love Actually,78,2003-11-07,45000000,59472278,248505300,203505300
Office Christmas Party,81,2016-12-09,45000000,54767494,91323299,46323299
"Yours, Mine and Ours",83,2005-11-23,45000000,53359917,72359917,27359917
Kicking and Screaming,84,2005-05-13,45000000,52842724,55842724,10842724
The Hitchhiker's Guide to the Galaxy,85,2005-04-29,45000000,51019112,102746214,57746214
Resident Evil: Extinction,86,2007-09-21,45000000,50648679,149871103,104871103
Fat Albert,87,2004-12-25,45000000,48114556,48563556,3563556
Savages,88,2012-07-06,45000000,47323100,82513490,37513490
Blended,90,2014-05-23,45000000,46290741,127990741,82990741
All Eyez on Me,91,2017-06-16,45000000,44922302,54876855,9876855
Last Holiday,92,2006-01-13,45000000,38399961,43343247,-1656753
16 Blocks,93,2006-03-03,45000000,36895141,65595141,20595141
Cellular,95,2004-09-10,45000000,32003620,61475984,16475984
The Ant Bully,96,2006-07-28,45000000,28142535,49610898,4610898
Johnny English,97,2003-07-18,45000000,28013509,163126676,118126676
Aliens in the Attic,99,2009-07-31,45000000,25200412,59551283,14551283
Across the Universe,100,2007-09-14,45000000,24343673,29367143,-15632857
Revolutionary Road,1,2008-12-26,45000000,22951340,79604820,34604820
Babylon A.D.,2,2008-08-29,45000000,22532572,70216497,25216497
The Pledge,7,2001-01-19,45000000,19719930,29406132,-15593868
The Producers: The Movie Musical,8,2005-12-16,45000000,19398532,32952995,-12047005
Rebound,10,2005-07-01,45000000,16809014,17492014,-27507986
The Ghost Writer,11,2010-02-19,45000000,15541549,65532491,20532491
All the Pretty Horses,12,2000-12-22,45000000,15527125,18120267,-26879733
Bangkok Dangerous,13,2008-09-05,45000000,15298133,46598133,1598133
Dredd,15,2012-09-21,45000000,13414714,41467606,-3532394
The Rum Diary,16,2011-10-28,45000000,13109815,21544732,-23455268
Welcome to Marwen,18,2018-12-21,45000000,10763520,12874922,-32125078
Johnny English Reborn,19,2011-10-21,45000000,8406711,164640401,119640401
Miracle at St. Anna,20,2008-09-26,45000000,7916887,9676497,-35323503
Big Trouble,21,2002-04-05,45000000,7262288,8488871,-36511129
Man cheng jin dai huang jin jia,22,2006-12-21,45000000,6566773,76904429,31904429
Love in the Time of Cholera,23,2007-11-16,45000000,4617608,31077418,-13922582
Pinocchio,24,2002-12-25,45000000,3681811,31681811,-13318189
Foodfight!,26,2012-12-31,45000000,0,73706,-44926294
Argo,27,2012-10-12,44500000,136025503,227140757,182640757
Charlie St. Cloud,31,2010-07-30,44000000,31206263,48478084,4478084
The Interview,33,2014-02-06,44000000,6105175,12342632,-31657368
The Heat,35,2013-06-28,43000000,159581587,229727774,186727774
Finding Forrester,36,2000-12-19,43000000,51768623,80013623,37013623
28 Days,37,2000-04-14,43000000,37035515,62063972,19063972
Danny the Dog,38,2005-05-13,43000000,24537621,49037621,6037621
The Sweetest Thing,39,2002-04-12,43000000,24430272,63078756,20078756
The Girl in the Spiderâs Web,40,2018-11-09,43000000,14828555,34983342,-8016658
A Monster Calls,41,2017-01-06,43000000,3740823,46414530,3414530
The Mechanic,42,2011-01-28,42500000,29121498,76347393,33847393
21 Jump Street,44,2012-03-16,42000000,138447667,202812429,160812429
Chicken Run,46,2000-06-21,42000000,106793915,227793915,185793915
Along Came Polly,47,2004-01-16,42000000,88073507,173044410,131044410
BrÃ¼no,49,2009-07-10,42000000,60054530,138708527,96708527
Snatched,51,2017-05-12,42000000,45852178,57852177,15852177
Here Comes the Boom,52,2012-10-12,42000000,45290318,73239258,31239258
High Crimes,53,2002-04-05,42000000,41543207,63781100,21781100
Red Riding Hood,55,2011-03-11,42000000,37662162,91678442,49678442
The Mothman Prophecies,56,2002-01-25,42000000,35228696,56438555,14438555
Holmes & Watson,58,2018-12-25,42000000,30568743,41926605,-73395
One for the Money,59,2012-01-27,42000000,26414527,36197221,-5802779
15 Minutes,60,2001-03-09,42000000,24375436,56331864,14331864
Lord of War,61,2005-09-16,42000000,24149632,60437727,18437727
Man on a Ledge,64,2012-01-27,42000000,18620000,49621440,7621440
The Warrior's Way,65,2010-12-03,42000000,5666340,8514325,-33485675
Micmacs,67,2010-05-28,42000000,1259693,11756922,-30243078
Les BronzÃ©s 3: amis pour la vie,68,2006-12-31,42000000,0,83833602,41833602
Pourquoi j'ai pas mangÃ© mon pÃ¨re,69,2015-12-31,42000000,0,15451663,-26548337
8 Mile,70,2002-11-08,41000000,116724075,245768384,204768384
A Knightâs Tale,72,2001-05-11,41000000,56083966,100622586,59622586
The Medallion,73,2003-08-22,41000000,22108977,22108977,-18891023
The Big Year,74,2011-10-14,41000000,7204138,7684524,-33315476
Wedding Crashers,76,2005-07-15,40000000,209218368,283218368,243218368
The Karate Kid,77,2010-06-11,40000000,176591618,351774938,311774938
Fifty Shades of Grey,78,2015-02-13,40000000,166167230,570998101,530998101
The Proposal,79,2009-06-19,40000000,163958031,314709717,274709717
American Hustle,80,2013-12-13,40000000,150117807,257878294,217878294
Cheaper by the Dozen,82,2003-12-25,40000000,138614544,190212113,150212113
Lucy,83,2014-07-25,40000000,126573960,457507776,417507776
Lone Survivor,84,2013-12-25,40000000,125095601,149804632,109804632
Spy Kids 3-D: Game Over,87,2003-07-25,40000000,111760631,167851995,127851995
The Conjuring 2: The Enfield Poltergeist,90,2016-06-10,40000000,102470008,311262102,271262102
The Social Network,91,2010-10-01,40000000,96962694,224922135,184922135
Julie & Julia,92,2009-08-07,40000000,94125426,126646119,86646119
He's Just Not That Into You,93,2009-02-06,40000000,93953653,181053657,141053657
John Wick: Chapter Two,94,2017-02-10,40000000,92029184,171350009,131350009
Ride Along 2,95,2016-01-15,40000000,90862685,124827316,84827316
Scary Movie 4,96,2006-04-14,40000000,90710620,178710620,138710620
Get Hard,97,2015-03-27,40000000,90411453,106511453,66511453
Scream 3,98,2000-02-04,40000000,89138076,161838076,121838076
The Accountant,100,2016-10-14,40000000,86260045,152962083,112962083
Dumb and Dumber To,1,2014-11-14,40000000,86208010,156553592,116553592
The Other Woman,2,2014-04-25,40000000,83911193,195111193,155111193
Eight Below,4,2006-02-17,40000000,81612565,120455994,80455994
The Intern,6,2015-09-25,40000000,75764672,197115710,157115710
Ray,8,2004-10-29,40000000,75305995,124823094,84823094
Sin City,9,2005-04-01,40000000,74103820,158527918,118527918
Bridge of Spies,10,2015-10-16,40000000,72313754,162498338,122498338
Vantage Point,11,2008-02-22,40000000,72266306,150886329,110886329
"I Love You, Man",12,2009-03-20,40000000,72013010,92302502,52302502
Shallow Hal,13,2001-11-09,40000000,70836296,70836296,30836296
Big Momma's House 2,15,2006-01-27,40000000,70165972,137047376,97047376
The House with a Clock in its Walls,16,2018-09-21,40000000,68549695,126331750,86331750
Hacksaw Ridge,17,2016-11-04,40000000,67209615,168904682,128904682
The Mexican,18,2001-03-02,40000000,66808615,145238250,105238250
The Final Destination,19,2009-08-28,40000000,66477700,187384627,147384627
17 Again,20,2009-04-17,40000000,64167069,139474906,99474906
Unknown,21,2011-02-18,40000000,63686397,136123083,96123083
Get Him to the Greek,22,2010-06-04,40000000,61153526,91455875,51455875
Gothika,23,2003-11-21,40000000,59588068,141484812,101484812
Behind Enemy Lines,24,2001-11-30,40000000,58855732,58855732,18855732
The Lincoln Lawyer,25,2011-03-18,40000000,58009200,87145086,47145086
Shall We Dance?,26,2004-10-15,40000000,57887882,118097882,78097882
Invincible,27,2006-08-25,40000000,57806952,58501127,18501127
Escape From Planet Earth,28,2013-02-15,40000000,57012977,74156610,34156610
Horrible Bosses 2,31,2014-11-26,40000000,54445357,105945357,65945357
The Count of Monte Cristo,32,2002-01-25,40000000,54228104,75389090,35389090
The Prestige,33,2006-10-20,40000000,53089891,104407366,64407366
The Lake House,34,2006-06-16,40000000,52330111,114830111,74830111
Predators,35,2010-07-09,40000000,52000688,127234389,87234389
The Odd Life of Timothy Green,36,2012-08-15,40000000,51853450,55249159,15249159
Apocalypto,38,2006-12-08,40000000,50866635,121032272,81032272
Music and Lyrics,39,2007-02-14,40000000,50572589,146196885,106196885
Secret Window,41,2004-03-12,40000000,47958031,92111551,52111551
The Skeleton Key,42,2005-08-12,40000000,47907715,92256918,52256918
Jersey Boys,43,2014-06-20,40000000,47047013,65282732,25282732
Made of Honor,44,2008-05-02,40000000,46012734,106548738,66548738
A Million Ways to Die in The West,48,2014-05-30,40000000,42720965,86778557,46778557
Final Destination 5,49,2011-08-12,40000000,42587643,155011165,115011165
Widows,50,2018-11-16,40000000,42402632,73866088,33866088
Fever Pitch,51,2005-04-08,40000000,42071069,50071069,10071069
Aliens vs. Predator - Requiem,52,2007-12-25,40000000,41797066,128884494,88884494
The Water Horse: Legend of the Deep,53,2007-12-25,40000000,40412817,103429755,63429755
Sex Tape,54,2014-07-18,40000000,38543473,126069509,86069509
Scream 4,55,2011-04-15,40000000,38180928,95989590,55989590
Autumn in New York,57,2000-08-11,40000000,37752931,90717684,50717684
Paul,58,2011-03-18,40000000,37412945,101162106,61162106
The Guilt Trip,59,2012-12-19,40000000,37134215,41294674,1294674
Colombiana,60,2011-08-26,40000000,36665854,72295262,32295262
The Commuter,62,2018-01-12,40000000,36343858,101985431,61985431
Hanging Up,63,2000-02-18,40000000,36037909,51867723,11867723
Pay it Forward,66,2000-10-20,40000000,33508922,55696705,15696705
Arthur,67,2011-04-08,40000000,33035397,47787943,7787943
Drillbit Taylor,68,2008-03-21,40000000,32862104,49686263,9686263
Patriots Day,69,2016-12-21,40000000,31886361,52837989,12837989
Extremely Loud and Incredibly Close,70,2011-12-25,40000000,31847881,55247881,15247881
Transporter 3,72,2008-11-26,40000000,31715062,107235592,67235592
Morning Glory,73,2010-11-10,40000000,31011732,59795070,19795070
Get Rich or Die Tryin',74,2005-11-09,40000000,30981850,46666955,6666955
The Art of War,76,2000-08-25,40000000,30199105,30199105,-9800895
Grudge Match,77,2013-12-25,40000000,29807260,69807260,29807260
Bless the Child,78,2000-08-11,40000000,29374178,40435694,435694
Rent,79,2005-11-23,40000000,29077547,31670620,-8329380
The Nut Job 2: Nutty by Nature,81,2017-08-11,40000000,28370522,57438389,17438389
The Musketeer,83,2001-09-07,40000000,27053815,27053815,-12946185
Resident Evil: The Final Chapter,84,2017-01-27,40000000,26844692,314101190,274101190
The Other Boleyn Girl,85,2008-02-29,40000000,26814957,78269970,38269970
The House,86,2017-06-30,40000000,25584504,31192425,-8807575
Sweet November,87,2001-02-16,40000000,25288103,65754228,25754228
The Reaping,88,2007-04-05,40000000,25126214,62226214,22226214
Season of the Witch,89,2011-01-07,40000000,24827228,91126600,51126600
City by the Sea,92,2002-09-06,40000000,22433915,22433915,-17566085
Mechanic: Resurrection,94,2016-08-26,40000000,21218403,109738840,69738840
Torque,95,2004-01-16,40000000,21176322,46176322,6176322
Fantastic Mr. Fox,96,2009-11-13,40000000,21002919,47083412,7083412
Big Miracle,99,2012-02-03,40000000,20157300,25268680,-14731320
The Impossible,100,2012-12-21,40000000,19019882,169590606,129590606
A Thousand Words,1,2012-03-09,40000000,18450127,20790486,-19209514
Marie Antoinette,2,2006-10-20,40000000,15962471,60862471,20862471
Get Carter,3,2000-10-06,40000000,14967182,19417182,-20582818
"Life, or Something Like It",5,2002-04-26,40000000,14448589,14448589,-25551411
Amelia,8,2009-10-23,40000000,14279575,19756077,-20243923
Cirque du Freak: The Vampire's Assistant,9,2009-10-23,40000000,14046595,39753957,-246043
New York Minute,10,2004-05-07,40000000,14018364,21215882,-18784118
Alfie,12,2004-11-05,40000000,13395939,35195939,-4804061
FearDotCom,13,2002-08-30,40000000,13208023,13208023,-26791977
Soul Men,14,2008-11-07,40000000,12082391,12345883,-27654117
The Gunman,15,2015-03-20,40000000,10664749,18594227,-21405773
Pandorum,17,2009-09-25,40000000,10330853,17033431,-22966569
Duplex,18,2003-09-26,40000000,9652000,10070651,-29929349
Paranoia,19,2013-08-16,40000000,7388654,16340767,-23659233
Baahubali: The Beginning,21,2015-07-10,40000000,6738000,26736665,-13263335
The Hurricane Heist,22,2018-03-09,40000000,6115824,30963684,-9036316
Impostor,23,2002-01-04,40000000,6114237,7974607,-32025393
Victor Frankenstein,24,2015-11-25,40000000,5775076,31124367,-8875633
Extreme Ops,25,2002-11-27,40000000,4835968,12624471,-27375529
Just Visiting,26,2001-04-06,40000000,4777007,16172200,-23827800
Snowpiercer,27,2014-06-27,40000000,4563029,88069880,48069880
Sunshine,28,2007-07-20,40000000,3688560,32030610,-7969390
Billy Lynnâs Long Halftime Walk,30,2016-11-11,40000000,1738477,30230402,-9769598
Delgo,32,2008-12-12,40000000,915840,915840,-39084160
The Hunting Party,33,2007-09-07,40000000,876671,7729552,-32270448
Alex Rider: Operation Stormbreaker,34,2006-10-13,40000000,659210,20722450,-19277550
Red Cliff,35,2009-11-20,40000000,627047,119627047,79627047
The Last Shot,36,2004-09-24,40000000,463730,463730,-39536270
Nomad,37,2007-03-16,40000000,79123,79123,-39920877
Un monstre Ã Paris,38,2013-04-16,40000000,0,27000381,-12999619
USS Indianapolis: Men of Courage,40,2016-11-11,40000000,0,1663785,-38336215
Dragon Nest Warriors' Dawn,41,2014-12-31,40000000,0,734423,-39265577
The Crow,42,2018-12-31,40000000,0,0,-40000000
The Time Traveler's Wife,45,2009-08-14,39000000,63414846,102332135,63332135
Because I Said So,47,2007-02-02,39000000,42674040,69538833,30538833
Frankenweenie,48,2012-10-05,39000000,35287788,81150788,42150788
Serenity,50,2005-09-30,39000000,25514517,40319440,1319440
Shoot 'Em Up,51,2007-09-07,39000000,12796824,26796824,-12203176
Against the Ropes,52,2004-02-20,39000000,5881504,6429865,-32570135
Yi dai zong shi,53,2013-08-23,38600000,6594959,57987299,19387299
The Fast and the Furious,54,2001-06-22,38000000,144512310,206512310,168512310
Sweet Home Alabama,55,2002-09-27,38000000,127214072,182365114,144365114
The Ugly Truth,56,2009-07-24,38000000,88915214,205298907,167298907
Spy Kids 2: The Island of Lost Dreams,57,2002-08-07,38000000,85846296,119721296,81721296
Captain Underpants: The First Epic Movie,59,2017-06-02,38000000,73921000,126577874,88577874
Paul Blart: Mall Cop 2,60,2015-04-17,38000000,71091594,107650646,69650646
Why Him?,62,2016-12-23,38000000,60323786,117425156,79425156
Water for Elephants,63,2011-04-22,38000000,58709717,116809717,78809717
Life as We Know It,64,2010-10-08,38000000,53374681,105887837,67887837
Riddick,66,2013-09-06,38000000,42025135,94763758,56763758
Heartbreakers,67,2001-03-23,38000000,40334024,57753825,19753825
Enough,68,2002-05-24,38000000,39177215,50970660,12970660
The 5th Wave,69,2016-01-22,38000000,34912982,111336398,73336398
Push,70,2009-02-06,38000000,31811527,49678401,11678401
Rush,71,2013-09-20,38000000,26947624,98230839,60230839
Angel Eyes,72,2001-05-18,38000000,24044532,29544532,-8455468
Joe Somebody,73,2001-12-21,38000000,22770864,24515990,-13484010
The Ninth Gate,74,2000-03-10,38000000,18653746,58394308,20394308
Only the Brave,75,2017-10-20,38000000,18340051,24555177,-13444823
The Thing,77,2011-10-14,38000000,16999934,27573078,-10426922
Rock Star,78,2001-09-07,38000000,16991902,19317765,-18682235
City of Ember,80,2008-10-10,38000000,7873007,17831558,-20168442
The Sisters Brothers,82,2018-09-21,38000000,3143056,13143056,-24856944
Texas Rangers,83,2001-11-30,38000000,623374,623374,-37376626
Virgin Territory,84,2008-08-26,38000000,0,5473041,-32526959
What to Expect When You're Expecting,86,2012-05-18,37500000,41152203,88473016,50973016
The Master,87,2012-09-14,37500000,16247159,50647416,13147416
The Express,88,2008-10-10,37500000,9793406,9813309,-27686691
Twilight,89,2008-11-21,37000000,192769854,402280159,365280159
We're the Millers,90,2013-08-07,37000000,150394119,267816276,230816276
Creed,91,2015-11-25,37000000,109767581,173567581,136567581
The Town,92,2010-09-17,37000000,92186262,152566881,115566881
Dolphin Tale,93,2011-09-23,37000000,72286779,96068724,59068724
Game Night,94,2018-02-23,37000000,69179066,117378084,80378084
Burn After Reading,95,2008-09-12,37000000,60355347,168167798,131167798
13 Going On 30,96,2004-04-23,37000000,57139723,97658712,60658712
Nim's Island,97,2008-04-04,37000000,48006762,101857425,64857425
How to be Single,98,2016-02-12,37000000,46843513,100003780,63003780
Cop Out,99,2010-02-26,37000000,44875481,55909910,18909910
The Rite,100,2011-01-28,37000000,33047633,97143987,60143987
Space Chimps,1,2008-07-18,37000000,30105968,67029956,30029956
Aloha,3,2015-05-29,37000000,21052030,25387091,-11612909
Obitaemyy ostrov,4,2009-12-31,36500000,0,15000000,-21500000
A Star is Born,5,2018-10-05,36000000,215288866,433449571,397449571
Gnomeo and Juliet,6,2011-02-11,36000000,99967670,193737977,157737977
John Q,7,2002-02-15,36000000,71026631,102226631,66226631
Hot Tub Time Machine,10,2010-03-26,36000000,50269859,65967750,29967750
Dolphin Tale 2,12,2014-09-12,36000000,42024533,57824533,21824533
Collateral Beauty,13,2016-12-16,36000000,31016021,85309093,49309093
A Man Apart,14,2003-04-04,36000000,26500000,43797731,7797731
Reindeer Games,15,2000-02-25,36000000,23360779,23360779,-12639221
Isn't She Great,19,2000-01-28,36000000,2954405,2954405,-33045595
Yip Man 3,20,2016-01-22,36000000,2679437,157300954,121300954
There Be Dragons,21,2011-05-06,36000000,1069334,4020990,-31979010
Queen of the Desert,22,2017-04-14,36000000,0,1578543,-34421457
Head of State,23,2003-03-28,35200000,37788228,38283765,3083765
It,24,2017-09-08,35000000,327481748,697457969,662457969
The Hangover,25,2009-06-05,35000000,277322503,465764086,430764086
The Blind Side,26,2009-11-20,35000000,255959475,305705794,270705794
True Grit,29,2010-12-22,35000000,171243005,252276928,217276928
Identity Thief,32,2013-02-08,35000000,134506920,175361578,140361578
The Devil Wears Prada,33,2006-06-30,35000000,124740460,326073155,291073155
Horrible Bosses,34,2011-07-08,35000000,117538559,212417601,177417601
Spy Kids,35,2001-03-30,35000000,112692062,197692062,162692062
Trainwreck,36,2015-07-17,35000000,110212700,141123897,106123897
Saving Mr. Banks,37,2013-12-13,35000000,83299761,114962525,79962525
21,39,2008-03-28,35000000,81159365,159846429,124846429
What Happens in Vegas...,40,2008-05-09,35000000,80277646,218535708,183535708
Hotel for Dogs,43,2009-01-16,35000000,73178547,122357172,87357172
Guess Who,44,2005-03-25,35000000,68915888,102115888,67115888
This is 40,45,2012-12-21,35000000,67544505,90221182,55221182
Sky High,47,2005-07-29,35000000,63939454,83109359,48109359
A Nightmare on Elm Street,49,2010-04-30,35000000,63075011,117729621,82729621
The Cell,50,2000-08-18,35000000,61280963,85911226,50911226
The Benchwarmers,52,2006-04-07,35000000,59843754,65063726,30063726
Secretariat,53,2010-10-08,35000000,59699513,60376247,25376247
Friends with Benefits,55,2011-07-22,35000000,55802754,146595891,111595891
Neighbors 2: Sorority Rising,56,2016-05-20,35000000,55340730,108757621,73757621
TMNT,57,2007-03-23,35000000,54149098,96096018,61096018
Radio,58,2003-10-24,35000000,52333738,53293628,18293628
Sicario: Day of the Soldado,59,2018-06-29,35000000,50065850,75885196,40885196
Old Dogs,60,2009-11-25,35000000,49492060,95104304,60104304
Poltergeist,62,2015-05-22,35000000,47425125,95713069,60713069
Goosebumps 2: Haunted Halloween,63,2018-10-12,35000000,46697321,93291478,58291478
12 Strong,64,2018-01-19,35000000,45819713,71118378,36118378
Underworld 3: Rise of the Lycans,65,2009-01-23,35000000,45802315,89102315,54102315
Must Love Dogs,66,2005-07-29,35000000,43894863,58405313,23405313
License to Wed,67,2007-07-03,35000000,43799818,70187088,35187088
Max Payne,69,2008-10-17,35000000,40689393,87775050,52775050
Resident Evil,70,2002-03-15,35000000,40119709,103787401,68787401
The Ladykillers,71,2004-03-26,35000000,39692139,77392139,42392139
Something Borrowed,72,2011-05-06,35000000,39046489,65084116,30084116
The Nativity Story,73,2006-12-01,35000000,37629831,46309644,11309644
In Time,74,2011-10-28,35000000,37553932,165103952,130103952
The Back-up Plan,75,2010-04-23,35000000,37490007,75281179,40281179
J. Edgar,76,2011-11-09,35000000,37306030,84606030,49606030
Bounce,77,2000-11-17,35000000,36805288,53425292,18425292
Mile 22,78,2018-08-17,35000000,36108758,66295121,31295121
Hot Pursuit,79,2015-05-08,35000000,34580201,45671512,10671512
Concussion,80,2015-12-25,35000000,34531832,50363790,15363790
The Foreigner,81,2017-10-13,35000000,34393507,140783360,105783360
Closer,82,2004-12-03,35000000,33987757,116177695,81177695
Black Knight,84,2001-11-21,35000000,33422806,33422806,-1577194
The Bad News Bears,85,2005-07-22,35000000,32868349,33500620,-1499380
The Pianist,86,2002-12-27,35000000,32519322,111854182,76854182
House of Wax,87,2005-05-06,35000000,32064800,70064800,35064800
From Hell,88,2001-10-19,35000000,31598308,68712365,33712365
Adrift,89,2018-06-01,35000000,31445011,57897191,22897191
Mirrors,90,2008-08-15,35000000,30691439,77220596,42220596
Underworld: Blood Wars,91,2017-01-06,35000000,30353973,81209222,46209222
Queen of the Damned,92,2002-02-22,35000000,30307804,30307804,-4692196
Nanny McPhee and the Big Bang,93,2010-08-20,35000000,29197642,97799865,62799865
Untraceable,94,2008-01-25,35000000,28687835,52649951,17649951
Abduction,96,2011-09-23,35000000,28087155,86648359,51648359
Superhero Movie,98,2008-03-28,35000000,26638520,73026302,38026302
Alex Cross,100,2012-10-19,35000000,25888412,35426759,426759
Jersey Girl,1,2004-03-26,35000000,25266129,37066129,2066129
Bridget Jonesâs Baby,3,2016-09-16,35000000,24139805,205822688,170822688
Heist,4,2001-11-09,35000000,23483357,28906817,-6093183
Whiskey Tango Foxtrot,6,2016-03-04,35000000,23083334,25350747,-9649253
Ella Enchanted,7,2004-04-09,35000000,22913677,22913677,-12086323
Hitman: Agent 47,8,2015-08-21,35000000,22467450,82182803,47182803
The X-Files: I Want to Believe,9,2008-07-25,35000000,20982478,68170792,33170792
Premium Rush,10,2012-08-24,35000000,20275446,31393201,-3606799
Broken City,11,2013-01-18,35000000,19701164,34480045,-519955
Valiant,12,2005-08-19,35000000,19478106,64188387,29188387
Wonder Boys,13,2000-02-23,35000000,19389454,33422485,-1577515
Cursed,14,2005-02-25,35000000,19294901,25114901,-9885099
Walk Hard: The Dewey Cox Story,15,2007-12-21,35000000,18317151,20606053,-14393947
The Four Feathers,16,2002-09-20,35000000,18306166,29882645,-5117355
Furry Vengeance,17,2010-04-30,35000000,17630465,39340177,4340177
Parker,18,2013-01-25,35000000,17616641,48543388,13543388
Wimbledon,19,2004-09-17,35000000,16862585,41666476,6666476
Bait,20,2000-09-15,35000000,15325127,15471969,-19528031
Dungeons and Dragons,21,2000-12-08,35000000,15185241,33771965,-1228035
Lions for Lambs,22,2007-11-09,35000000,14998070,63211088,28211088
The Tree of Life,24,2011-05-27,35000000,13305665,61721826,26721826
American Outlaws,25,2001-08-17,35000000,13264986,13601109,-21398891
Zoom,26,2006-08-11,35000000,11989328,12506188,-22493812
The Shipping News,27,2001-12-25,35000000,11405825,24405825,-10594175
The Young Victoria,28,2009-12-18,35000000,11001272,31878891,-3121109
Sabotage,29,2014-03-28,35000000,10508518,18376443,-16623557
Whiteout,31,2009-09-11,35000000,10275638,12254746,-22745254
Unfinished Business,32,2015-03-06,35000000,10219501,13214051,-21785949
The Walk,33,2015-09-30,35000000,10161183,61492104,26492104
The Fountain,34,2006-11-22,35000000,10144010,15461638,-19538362
Mandela: Long Walk to Freedom,35,2013-11-29,35000000,8323085,29890402,-5109598
Punisher: War Zone,36,2008-12-05,35000000,8050977,10157534,-24842466
The Order,37,2003-09-05,35000000,7659747,11559747,-23440253
A Good Year,38,2006-11-10,35000000,7459300,42064105,7064105
The Brothers Grimsby,39,2016-03-11,35000000,6864016,28720470,-6279530
The Snowman,40,2017-10-20,35000000,6670765,43226146,8226146
Femme Fatale,41,2002-11-06,35000000,6630252,16830252,-18169748
Luther,43,2003-09-26,35000000,5781086,32717063,-2282937
Biutiful,44,2011-01-28,35000000,5101237,24687524,-10312476
A Hologram for the King,47,2016-04-22,35000000,4212494,11846010,-23153990
Stolen,53,2012-09-14,35000000,289773,17967746,-17032254
Trespass,54,2011-10-14,35000000,16816,786532,-34213468
Bandidas,55,2006-09-22,35000000,0,19282590,-15717410
The Lovers,56,2015-03-13,35000000,0,53899,-34946101
Black Water Transit,57,2008-12-31,35000000,0,0,-35000000
The Darkest Hour,58,2011-12-25,34800000,21443494,62831715,28031715
Baby Driver,59,2017-06-28,34000000,107825862,228104185,194104185
The Maze Runner,60,2014-09-19,34000000,102427862,348319861,314319861
The Longest Ride,61,2015-04-10,34000000,37446117,63802928,29802928
Gake no ue no Ponyo,63,2009-08-14,34000000,15090399,205312666,171312666
The Darkest Minds,64,2018-08-03,34000000,12695691,38361428,4361428
I Dreamed of Africa,67,2000-05-05,34000000,6543194,14291999,-19708001
Thunder and the House of Magic,68,2014-09-05,34000000,4091,62582520,28582520
Big Momma's House,71,2000-06-02,33000000,117559438,173559438,140559438
Exit Wounds,72,2001-03-16,33000000,51758599,79958599,46958599
Mike and Dave Need Wedding Dates,73,2016-07-08,33000000,46009673,75898100,42898100
Step Up Revolution,74,2012-07-27,33000000,35074677,165552290,132552290
Snakes on a Plane,75,2006-08-18,33000000,34020814,62020814,29020814
The Punisher,76,2004-04-16,33000000,33664370,54533774,21533774
The Watcher,77,2000-09-08,33000000,28946615,47267829,14267829
Safe,78,2012-04-27,33000000,17142080,41495213,8495213
Doomsday,79,2008-03-14,33000000,11008770,21621188,-11378812
Goal! The Dream Begins,81,2006-05-12,33000000,4283255,27610873,-5389127
The Young and Prodigious T.S. Spivet,82,2015-07-31,33000000,176847,357687,-32642313
Freaks of Nature,83,2015-10-30,33000000,70958,70958,-32929042
Bridesmaids,85,2011-05-13,32500000,169211718,289632023,257132023
The Reader,86,2008-12-10,32500000,34194407,112964875,80464875
The Big Wedding,87,2013-04-26,32500000,21819348,48425971,15925971
Wanderlust,88,2012-02-24,32500000,17288155,24159934,-8340066
Elf,89,2003-11-07,32000000,173840591,220678483,188678483
This is the End,91,2013-06-12,32000000,101470202,126539117,94539117
Snow Dogs,92,2002-01-18,32000000,81150692,116898028,84898028
Nacho Libre,93,2006-06-16,32000000,80197993,99296462,67296462
Takers,95,2010-08-27,32000000,57744720,70587268,38587268
Source Code,96,2011-04-01,32000000,54712227,140428499,108428499
Men of Honor,98,2000-11-10,32000000,48814909,82339483,50339483
I Feel Pretty,99,2018-04-20,32000000,48795601,91553797,59553797
The Transporter 2,100,2005-09-02,32000000,43095856,88978458,56978458
"Big Mommas: Like Father, Like Son",1,2011-02-18,32000000,37915414,82332450,50332450
The Number 23,3,2007-02-23,32000000,35193167,77593167,45593167
Dreamer: Inspired by a True Story,5,2005-10-21,32000000,33022286,39498360,7498360
A History of Violence,6,2005-09-23,32000000,31493782,61477797,29477797
The Incredible Burt Wonderstone,7,2013-03-15,32000000,22537881,27392609,-4607391
Laws of Attraction,9,2004-04-30,32000000,17848322,29948322,-2051678
Bad Times at the El Royale,10,2018-10-12,32000000,17839115,29204379,-2795621
Going the Distance,11,2010-09-03,32000000,17804299,43603990,11603990
Repo Men,13,2010-03-19,32000000,13942007,18195238,-13804762
Dragon Wars: D-War,14,2007-09-14,32000000,10977721,79915361,47915361
The Good German,18,2006-12-15,32000000,1308696,6678033,-25321967
George and the Dragon,19,2004-12-31,32000000,0,0,-32000000
Criminal,21,2016-04-15,31500000,14708696,38771262,7271262
42,22,2013-04-12,31000000,95020213,97470701,66470701
Flight,23,2012-11-02,31000000,93772375,160558438,129558438
The Grand Budapest Hotel,27,2014-03-07,31000000,59076019,163981261,132981261
Vacation,28,2015-07-29,31000000,58884188,102306500,71306500
Frequency,31,2000-04-28,31000000,44983704,68079671,37079671
Hearts in Atlantis,32,2001-09-28,31000000,24185781,30885781,-114219
Extraordinary Measures,33,2010-01-22,31000000,12482741,15826984,-15173016
Birth of the Dragon,34,2017-08-25,31000000,6901965,7220490,-23779510
Crazy Rich Asians,38,2018-08-15,30000000,174532921,238099711,208099711
Chicago,39,2002-12-27,30000000,170687518,306770545,276770545
American Pie 2,41,2001-08-10,30000000,145096820,286500000,256500000
The Vow,42,2012-02-10,30000000,125014030,197618160,167618160
Lee Daniels' The Butler,45,2013-08-16,30000000,116632095,177025498,147025498
Remember the Titans,46,2000-09-29,30000000,115654751,136706683,106706683
District 9,47,2009-08-14,30000000,115646235,212453431,182453431
Dodgeball: A True Underdog Story,48,2004-06-18,30000000,114326736,167791704,137791704
The Princess Diaries,51,2001-08-03,30000000,108244774,165334774,135334774
Million Dollar Baby,54,2004-12-15,30000000,100492203,231928227,201928227
Mystic River,56,2003-10-08,30000000,90135191,156822020,126822020
Sisters,57,2015-12-18,30000000,87044645,106030660,76030660
SpongeBob SquarePants: The Movie,59,2004-11-19,30000000,85416609,142051255,112051255
Up in the Air,60,2009-12-04,30000000,83823381,166842739,136842739
The Notebook,61,2004-06-25,30000000,81001787,116025023,86025023
Hannah Montana the Movie,62,2009-04-10,30000000,79576189,169173206,139173206
27 Dresses,63,2008-01-18,30000000,76808654,160247805,130247805
Rugrats in Paris,64,2000-11-17,30000000,76501438,103284813,73284813
The Hitmanâs Bodyguard,65,2017-08-18,30000000,75468583,172778667,142778667
Four Brothers,67,2005-08-12,30000000,74494381,92494381,62494381
Looper,69,2012-09-28,30000000,66486205,170466405,140466405
Warm Bodies,70,2013-02-01,30000000,66380662,115121608,85121608
About Schmidt,71,2002-12-13,30000000,65005217,107054484,77054484
The Nut Job,72,2014-01-17,30000000,64251538,122529966,92529966
Down to Earth,73,2001-02-16,30000000,64172251,71172251,41172251
Hope Springs,75,2012-08-08,30000000,63536011,133085295,103085295
Forgetting Sarah Marshall,76,2008-04-18,30000000,63172463,105173042,75173042
Friday Night Lights,77,2004-10-08,30000000,61255921,61950770,31950770
Baby Mama,79,2008-04-25,30000000,60494212,64170447,34170447
Bride Wars,81,2009-01-09,30000000,58715510,115150424,85150424
Without a Paddle,82,2004-08-20,30000000,58156435,65121280,35121280
Midnight in Paris,83,2011-05-20,30000000,56816662,162502774,132502774
Darkest Hour,84,2017-11-22,30000000,56443120,150807172,120807172
Wallace & Gromit: The Curse of the Were-Rabbit,85,2005-10-05,30000000,56068547,197593152,167593152
P.S. I Love You,86,2007-12-21,30000000,53695808,155769678,125769678
Corpse Bride,87,2005-09-23,30000000,53359111,114770654,84770654
Life of the Party,88,2018-05-11,30000000,53059911,65759911,35759911
Letters to Juliet,89,2010-05-14,30000000,53032453,82148538,52148538
Blow,90,2001-04-06,30000000,52990775,83282296,53282296
Southpaw,92,2015-07-24,30000000,52421953,94156456,64156456
Atomic Blonde,94,2017-07-28,30000000,51573925,98345423,68345423
Like Mike,95,2002-07-03,30000000,51432423,62432423,32432423
Atonement,97,2007-12-07,30000000,50980159,129779728,99779728
Racing Stripes,99,2005-01-14,30000000,49772522,89955540,59955540
Sicario,100,2015-09-18,30000000,46889293,84393749,54393749
Den of Thieves,3,2018-01-19,30000000,44947622,80131391,50131391
The Three Stooges,4,2012-04-13,30000000,44338224,54052249,24052249
Pokemon 2000,5,2000-07-21,30000000,43746923,133946923,103946923
John Wick,6,2014-10-24,30000000,43037835,76235001,46235001
Glory Road,7,2006-01-13,30000000,42647449,42799060,12799060
The Age of Adaline,8,2015-04-24,30000000,42629776,68984536,38984536
Step Up 3D,9,2010-08-06,30000000,42400223,165889117,135889117
Drag Me To Hell,10,2009-05-29,30000000,42100625,91388487,61388487
The Cabin in the Woods,11,2012-04-13,30000000,42073277,70689968,40689968
Secondhand Lions,12,2003-09-19,30000000,42070939,47902566,17902566
Stranger Than Fiction,13,2006-11-10,30000000,40435190,53572822,23572822
Hanna,14,2011-04-08,30000000,40259119,65343694,35343694
Blue Crush,15,2002-08-16,30000000,40118420,51618420,21618420
30 Days of Night,16,2007-10-19,30000000,39568996,80276156,50276156
Gridiron Gang,18,2006-09-15,30000000,38432823,41457834,11457834
Meet the Spartans,20,2008-01-25,30000000,38233676,84646831,54646831
The Family,22,2013-09-13,30000000,36918811,51078541,21078541
The 15:17 to Paris,23,2018-02-09,30000000,36276286,56096200,26096200
Larry Crowne,25,2011-07-01,30000000,35608245,61449135,31449135
Carrie,26,2013-10-18,30000000,35266619,82409520,52409520
Take the Lead,27,2006-04-07,30000000,34742066,65390493,35390493
Death Wish,28,2018-03-02,30000000,34017028,48575965,18575965
Love and Other Drugs,29,2010-11-24,30000000,32367005,102716321,72716321
Entourage,30,2015-06-03,30000000,32363404,46438538,16438538
What's the Worst That Could Happen?,31,2001-06-01,30000000,32267774,38462071,8462071
Side Effects,32,2013-02-08,30000000,32172757,66742138,36742138
9,33,2009-09-09,30000000,31749894,48559999,18559999
Deliver Us from Evil,34,2014-07-02,30000000,30577122,87956618,57956618
Get on Up,35,2014-08-01,30000000,30569935,33339868,3339868
Mollyâs Game,36,2017-12-25,30000000,28780744,53296424,23296424
The Five-Year Engagement,37,2012-04-27,30000000,28700285,61623819,31623819
The Prince & Me,38,2004-04-02,30000000,28165882,29356757,-643243
Winnie the Pooh,39,2011-07-15,30000000,26692846,50145607,20145607
Dumb and Dumberer: When Harry Met Lloyd,41,2003-06-13,30000000,26214846,26214846,-3785154
White Boy Rick,42,2018-09-14,30000000,24004833,25947983,-4052017
Sanctum,45,2011-02-04,30000000,23209310,108957098,78957098
My Super Ex-Girlfriend,46,2006-07-21,30000000,22530295,60772856,30772856
Ballerina,47,2017-08-25,30000000,21858070,96892829,66892829
Mr. 3000,48,2004-09-17,30000000,21800302,21827296,-8172704
The Next Three Days,49,2010-11-19,30000000,21148651,67255916,37255916
Proud Mary,50,2018-01-12,30000000,20868638,21709539,-8290461
Little Black Book,51,2004-08-06,30000000,20422207,21758371,-8241629
Assault On Precinct 13,52,2005-01-19,30000000,20040895,36040895,6040895
Runner Runner,53,2013-10-04,30000000,19316646,60512680,30512680
Baahubali 2: The Conclusion,55,2017-04-28,30000000,18985794,263502914,233502914
Ultraviolet,56,2006-03-03,30000000,18522064,30962112,962112
North Country,57,2005-10-21,30000000,18324242,23676771,-6323229
Fright Night,58,2011-08-19,30000000,18298649,40520649,10520649
mother!,59,2017-09-15,30000000,17800004,42531076,12531076
Steve Jobs,60,2015-10-09,30000000,17766658,35579007,5579007
Eight Legged Freaks,61,2002-07-17,30000000,17266505,36722311,6722311
Splice,63,2010-06-04,30000000,17010170,28542494,-1457506
88 Minutes,64,2008-04-18,30000000,16930884,32955399,2955399
The Whole Ten Yards,65,2004-04-09,30000000,16323969,26323969,-3676031
Pride and Glory,67,2008-10-24,30000000,15740721,43440721,13440721
The Cave,68,2005-08-26,30000000,15007991,27147991,-2852009
Godsend,69,2004-04-30,30000000,14334645,16910708,-13089292
Alex & Emma,70,2003-06-20,30000000,14208384,15358583,-14641417
Wicker Park,71,2004-09-03,30000000,13001257,21577076,-8422924
The New World,72,2005-12-25,30000000,12712093,26184400,-3815600
Evening,73,2007-06-29,30000000,12406646,12885574,-17114426
The Last Stand,74,2013-01-18,30000000,12050299,48330757,18330757
Antitrust,77,2001-01-12,30000000,10965209,17865209,-12134791
Dead Man Down,78,2013-03-08,30000000,10895295,19599974,-10400026
Hoodwinked Too: Hood vs. Evil,79,2011-04-29,30000000,10143779,23353111,-6646889
Dragonball Evolution,80,2009-04-10,30000000,9362785,58228460,28228460
First Daughter,81,2004-09-24,30000000,9055010,10419084,-19580916
The Lost City of Z,82,2017-04-14,30000000,8574339,17121823,-12878177
An Unfinished Life,83,2005-09-09,30000000,8535575,18535575,-11464425
The Space Between Us,84,2017-02-03,30000000,7885294,16481405,-13518595
The Imaginarium of Doctor Parnassus,85,2009-12-25,30000000,7689607,64352607,34352607
Barney's Version,86,2011-01-14,30000000,7502560,8845575,-21154425
Trapped,87,2002-09-20,30000000,6916869,6916869,-23083131
Kin,88,2018-08-31,30000000,5718096,10096821,-19903179
Stronger,90,2017-09-22,30000000,4211129,8786752,-21213248
The Assassination of Jesse James by the Coward Robert Ford,92,2007-09-21,30000000,3909149,15313631,-14686369
The Merchant of Venice,93,2004-12-29,30000000,3765585,18765585,-11234415
The Good Thief,94,2003-04-02,30000000,3517797,6460758,-23539242
Supercross,95,2005-08-17,30000000,3102550,3252550,-26747450
Miss Potter,96,2006-12-29,30000000,3005605,35891257,5891257
Wu ji,97,2006-05-05,30000000,669625,35869934,5869934
Machine Gun Preacher,99,2011-09-23,30000000,538690,3721988,-26278012
Bilal: A New Breed of Hero,100,2018-02-02,30000000,490973,648599,-29351401
DOA: Dead or Alive,1,2007-06-15,30000000,480314,7755686,-22244314
Le Petit Nicolas,2,2010-02-19,30000000,201857,52339566,22339566
Xinhai geming,3,2011-10-07,30000000,135739,8593154,-21406846
Genghis Khan: To the Ends of the Earth and Sea,4,2008-02-21,30000000,3892,4874498,-25125502
Wild Card,5,2015-01-30,30000000,3200,4315789,-25684211
United Passions,6,2015-06-05,30000000,918,168832,-29831168
Konferenz der Tiere,7,2010-12-31,30000000,0,53048539,23048539
Grace of Monaco,8,2015-12-01,30000000,0,25199891,-4800109
Savva. Serdtse voyna,9,2016-03-08,30000000,0,5015080,-24984920
Goodbye Bafana,10,2007-12-14,30000000,0,2717302,-27282698
Space Pirate Captain Harlock,11,2013-12-31,30000000,0,310985,-29689015
Ripley's Game,12,2003-12-31,30000000,0,0,-30000000
Collide,13,2017-02-24,29200000,2280004,5466698,-23733302
Pitch Perfect 2,14,2015-05-15,29000000,184296230,287625468,258625468
Walk the Line,15,2005-11-18,29000000,119519402,187707495,158707495
Night School,16,2018-09-28,29000000,77339130,103008792,74008792
The Boss,17,2016-04-08,29000000,63077560,78652207,49652207
Once Upon a Time in Mexico,19,2003-09-12,29000000,56330657,97413527,68413527
Keeping the Faith,20,2000-04-14,29000000,37036404,45336404,16336404
Logan Lucky,21,2017-08-18,29000000,27778642,44264271,15264271
Florence Foster Jenkins,22,2016-08-12,29000000,27383770,56000339,27000339
Frost/Nixon,24,2008-12-05,29000000,18622031,28452945,-547055
Seed of Chucky,25,2004-11-12,29000000,17016190,24716190,-4283810
Serving Sara,26,2002-08-23,29000000,16930185,20146150,-8853850
Confessions of a Dangerous Mind,27,2002-12-31,29000000,16007718,33013805,4013805
Taking Woodstock,28,2009-08-26,29000000,7460204,10066366,-18933634
The Jacket,32,2005-03-04,28500000,6301131,15452978,-13047022
Straight Outta Compton,35,2015-08-14,28000000,161197785,202182981,174182981
Girls Trip,36,2017-07-21,28000000,115108515,140886353,112886353
Along Came a Spider,39,2001-04-06,28000000,74058698,105159085,77159085
A Bad Moms Christmas,40,2017-11-01,28000000,72110659,127710550,99710550
Safe Haven,41,2013-02-14,28000000,71399120,94050951,66050951
The Big Short,42,2015-12-11,28000000,70259870,133162752,105162752
Role Models,43,2008-11-07,28000000,67300955,94500826,66500826
"Alexander and the Terrible, Horrible, No Good, Very Bad Day",44,2014-10-10,28000000,66954149,101379287,73379287
Miracle,45,2004-02-06,28000000,64378093,64474705,36474705
Last Vegas,46,2013-01-28,28000000,63914167,112914167,84914167
The Wedding Planner,47,2001-01-26,28000000,60400856,94728529,66728529
Dawn of the Dead,48,2004-03-19,28000000,58990765,103452875,75452875
Tag,50,2018-06-15,28000000,54730625,77026186,49026186
The Royal Tenenbaums,51,2001-12-14,28000000,52353636,71430876,43430876
Identity,52,2003-04-25,28000000,52131264,82183683,54183683
Serendipity,53,2001-10-05,28000000,50255310,77477297,49477297
Kick-Ass,54,2010-04-16,28000000,48071303,97531134,69531134
Zoolander,55,2001-09-28,28000000,45172250,60780981,32780981
No Reservations,57,2007-07-27,28000000,43107979,91943956,63943956
Pride & Prejudice,59,2005-11-11,28000000,38372662,126549607,98549607
30 Minutes or Less,60,2011-08-12,28000000,37053924,40966716,12966716
Dracula 2000,61,2000-12-22,28000000,33000377,33000377,5000377
3 Days to Kill,64,2014-02-21,28000000,30697999,38959900,10959900
Kick-Ass 2,65,2013-08-16,28000000,28795985,63129909,35129909
We Own the Night,66,2007-10-12,28000000,28563179,55307857,27307857
A Walk Among the Tombstones,67,2014-09-19,28000000,26017685,62108587,34108587
The Spy Next Door,68,2010-01-15,28000000,24307106,46752858,18752858
Brick Mansions,69,2014-04-25,28000000,20396829,73421224,45421224
Just My Luck,70,2006-05-12,28000000,17326650,38159905,10159905
Lost Souls,71,2000-10-13,28000000,16779636,31320293,3320293
American Ultra,72,2015-08-21,28000000,14439985,30295028,2295028
Winged Migration,73,2003-04-18,28000000,11689053,39134983,11134983
Pride and Prejudice and Zombies,74,2016-02-05,28000000,10907291,16638300,-11361700
John Carpenterâs Ghosts of Mars,76,2001-08-24,28000000,8434601,8434601,-19565399
Our Brand is Crisis,78,2015-10-30,28000000,7002261,8594558,-19405442
How to Lose Friends & Alienate People,80,2008-10-03,28000000,2775593,12031443,-15968557
Alatriste,81,2007-12-31,28000000,0,22860477,-5139523
Knocked Up,82,2007-06-01,27500000,148761765,219265952,191765952
My Sister's Keeper,84,2009-06-26,27500000,49200230,96673002,69173002
Welcome Home Roscoe Jenkins,85,2008-02-08,27500000,42436517,43607627,16107627
Joyful Noise,86,2012-01-13,27500000,30932113,31157914,3657914
Notes on a Scandal,88,2006-12-25,27500000,17510118,50578411,23078411
Rendition,89,2007-10-19,27500000,9736045,26939925,-560075
Anonymous,90,2011-10-28,27500000,4463292,15815509,-11684491
Limitless,91,2011-03-18,27000000,79249455,155564919,128564919
The Divine Secrets of the Ya-Ya Sisterhood,93,2002-06-07,27000000,69586544,73826768,46826768
The Sisterhood of the Traveling Pants 2,97,2008-08-06,27000000,44089964,44270131,17270131
Money Monster,98,2016-05-13,27000000,41012075,93466095,66466095
About a Boy,99,2002-05-17,27000000,40803000,130759651,103759651
Spy Kids: All the Time in the World,100,2011-08-19,27000000,38536376,80681183,53681183
Lucky Number Slevin,2,2006-04-07,27000000,22495466,55495466,28495466
The Duchess,6,2008-09-19,27000000,13848978,45160110,18160110
Case 39,7,2010-10-01,27000000,13261851,28773827,1773827
The Honeymooners,8,2005-06-10,27000000,12834849,13174426,-13825574
Suspect Zero,11,2004-08-27,27000000,8712564,8712564,-18287436
Martian Child,12,2007-11-02,27000000,7500310,9352089,-17647911
Formula 51,13,2002-10-18,27000000,5204007,5204007,-21795993
Mindhunters,15,2005-05-13,27000000,4476235,16566235,-10433765
What Just Happened,16,2008-10-17,27000000,1090947,2412123,-24587877
The Statement,17,2003-12-12,27000000,765637,1545064,-25454936
The Magic Flute,18,2006-12-31,27000000,0,0,-27000000
Rules Donât Apply,19,2016-11-23,26700000,3652206,3871448,-22828552
Paul Blart: Mall Cop,20,2009-01-16,26000000,146336178,185904750,159904750
Freaky Friday,21,2003-08-06,26000000,110222438,160822438,134822438
The 40 Year-old Virgin,22,2005-08-19,26000000,109449237,177344230,151344230
Pineapple Express,25,2008-08-06,26000000,87341380,102404019,76404019
Open Range,29,2003-08-15,26000000,58331254,68613992,42613992
Red Eye,30,2005-08-19,26000000,57891803,96666486,70666486
New Yearâs Eve,31,2011-12-09,26000000,54544638,146850273,120850273
Pain & Gain,33,2013-04-26,26000000,49875291,81275291,55275291
Final Destination 2,34,2003-01-31,26000000,46896664,90396664,64396664
"O Brother, Where Art Thou?",35,2000-12-22,26000000,45506619,75763814,49763814
In Good Company,36,2004-12-29,26000000,45489752,63489752,37489752
Legion,37,2010-01-22,26000000,40168080,67647574,41647574
Lawless,38,2012-08-29,26000000,37397291,54393687,28393687
Clockstoppers,39,2002-03-29,26000000,36985501,38788828,12788828
Brothers,41,2009-12-04,26000000,28544157,45043870,19043870
The Best of Me,42,2014-10-17,26000000,26766213,41059418,15059418
Agent Cody Banks 2: Destination London,43,2004-03-12,26000000,23514247,28703083,2703083
Original Sin,44,2001-08-03,26000000,16521410,16521410,-9478590
The Raven,45,2012-04-27,26000000,16008272,30601801,4601801
Welcome to Mooseport,46,2004-02-20,26000000,14469428,14469428,-11530572
Self/Less,48,2015-07-10,26000000,12279691,33667319,7667319
The Curse of the Jade Scorpion,49,2001-08-24,26000000,7496522,18496522,-7503478
The Fifth Estate,50,2013-10-18,26000000,3254172,6154172,-19845828
Blood Ties,52,2014-03-21,26000000,42472,2923959,-23076041
Viy,54,2015-06-30,26000000,0,34246770,8246770
Accidental Love,55,2015-03-17,26000000,0,135436,-25864564
The Face of an Angel,56,2015-04-24,26000000,0,0,-26000000
The Constant Gardener,58,2005-08-31,25500000,33579798,86301599,60801599
W.,59,2008-10-17,25100000,25534493,28575778,3475778
The Passion of the Christ,60,2004-02-25,25000000,370782930,622341924,597341924
The Help,63,2011-08-10,25000000,169705587,213120004,188120004
Hidden Figures,64,2016-12-25,25000000,169607287,231771716,206771716
Gran Torino,65,2008-12-12,25000000,148095302,274543085,249543085
Taken,66,2009-01-30,25000000,145000989,226941585,201941585
Ride Along,67,2014-01-17,25000000,134202565,153733800,128733800
"Legally Blonde 2: Red, White & Blonde",70,2003-07-02,25000000,90639088,125339088,100339088
Scooby-Doo 2: Monsters Unleashed,71,2004-03-26,25000000,84185387,181185387,156185387
Anchorman: The Legend of Ron Burgundy,72,2004-07-09,25000000,84136909,89476265,64476265
Freddy vs. Jason,73,2003-08-15,25000000,82622655,114576403,89576403
Bridge to Terabithia,74,2007-02-16,25000000,82234139,137984788,112984788
Jimmy Neutron: Boy Genius,75,2001-12-21,25000000,80936232,102992536,77992536
Cloverfield,76,2008-01-18,25000000,80048433,171302226,146302226
Dear John,77,2010-02-05,25000000,80014842,142033509,117033509
Parental Guidance,79,2012-12-25,25000000,77267296,120832383,95832383
No Country for Old Men,81,2007-11-09,25000000,74273505,164035753,139035753
Bridget Jones's Diary,82,2001-04-13,25000000,71500556,281527158,256527158
Chocolat,83,2000-12-15,25000000,71309760,152500343,127500343
No Strings Attached,84,2011-01-21,25000000,70662220,149228078,124228078
Contraband,85,2012-01-13,25000000,66528000,98406855,73406855
A Dogâs Purpose,86,2017-01-27,25000000,64321890,203671625,178671625
The Lucky One,87,2012-04-20,25000000,60457138,96633833,71633833
Romeo Must Die,89,2000-03-22,25000000,55973336,91036760,66036760
The Omen,90,2006-06-06,25000000,54607383,119295584,94295584
Final Destination 3,91,2006-02-10,25000000,54098051,112798051,87798051
Madea's Big Happy Family,92,2011-04-22,25000000,53345287,54160818,29160818
Tyler Perry's A Madea Christmas,93,2013-12-13,25000000,52543354,52543354,27543354
Finding Neverland,94,2004-11-12,25000000,51676606,115036108,90036108
The Grey,95,2012-01-27,25000000,51580136,81249176,56249176
Hide and Seek,96,2005-01-28,25000000,51100486,123696741,98696741
The House Bunny,98,2008-08-22,25000000,48237389,71390601,46390601
Agent Cody Banks,99,2003-03-14,25000000,47545060,58240458,33240458
Nanny McPhee,100,2006-01-27,25000000,47279279,128745578,103745578
The Giver,2,2014-08-15,25000000,45090374,66540205,41540205
The Night Before,6,2015-11-20,25000000,43035725,52427346,27427346
The Hours,8,2002-12-27,25000000,41675994,97030468,72030468
There Will Be Blood,10,2007-12-26,25000000,40222514,77208711,52208711
The Wild Thornberrys Movie,11,2002-12-20,25000000,40108697,60694737,35694737
Rugrats Go Wild,12,2003-06-13,25000000,39402572,55443032,30443032
The Sisterhood of the Traveling Pants,13,2005-06-01,25000000,39053061,41560117,16560117
Undercover Brother,14,2002-05-31,25000000,38230435,40796145,15796145
August: Osage County,15,2013-12-25,25000000,37738810,50738810,25738810
Kiss of the Dragon,16,2001-07-06,25000000,36833473,36833473,11833473
Million Dollar Arm,17,2014-05-16,25000000,36447959,39217912,14217912
Beauty Shop,18,2004-01-01,25000000,36351350,38351350,13351350
What a Girl Wants,19,2003-04-04,25000000,35990505,35990505,10990505
Jeepers Creepers II,20,2003-08-29,25000000,35623801,119923801,94923801
Peppermint,21,2018-09-07,25000000,35418723,51800758,26800758
Good Luck Chuck,22,2007-09-21,25000000,35017297,59183821,34183821
Cradle 2 the Grave,23,2003-02-28,25000000,34657731,56434942,31434942
She's the Man,24,2006-03-17,25000000,33889159,55279608,30279608
The Gambler,25,2014-12-10,25000000,33680992,38718031,13718031
Mr. Beanâs Holiday,26,2007-08-24,25000000,33302167,234981342,209981342
Motherâs Day,27,2016-04-29,25000000,32492859,52367022,27367022
Fist Fight,29,2017-02-17,25000000,32187017,40286416,15286416
August Rush,30,2007-11-21,25000000,31664162,65882103,40882103
Anacondas: The Hunt for the Blood Orchid,31,2004-08-27,25000000,31526393,70326393,45326393
The Sitter,32,2011-12-09,25000000,30542576,38749404,13749404
Draft Day,36,2014-04-11,25000000,28842237,29847480,4847480
Rings,38,2017-02-03,25000000,27793018,82917283,57917283
Dance Flick,39,2009-05-22,25000000,25794018,32224624,7224624
Crocodile Dundee in Los Angeles,40,2001-04-20,25000000,25590119,39393111,14393111
Ice Princess,42,2005-03-18,25000000,24381334,25732334,732334
Don't Be Afraid of the Dark,43,2011-08-26,25000000,24046682,39126427,14126427
The Losers,44,2010-04-23,25000000,23591432,29863840,4863840
Fighting,45,2009-04-24,25000000,23091010,32831707,7831707
War,46,2007-08-24,25000000,22486409,40686409,15686409
A Lot Like Love,48,2005-04-22,25000000,21835784,41921590,16921590
The Eagle,50,2011-02-11,25000000,19490041,38993548,13993548
Shaun the Sheep,51,2015-08-05,25000000,19375982,101925161,76925161
Shark Night 3D,52,2011-09-02,25000000,18877153,18877153,-6122847
CHiPS,53,2017-03-24,25000000,18600152,23190292,-1809708
Punch-Drunk Love,54,2002-10-11,25000000,17791031,24591031,-408969
Eurotrip,55,2004-02-20,25000000,17718223,20718223,-4281777
Father Figures,56,2017-12-22,25000000,17501244,21038441,-3961559
The Ruins,57,2008-04-04,25000000,17432844,22910563,-2089437
The Counselor,58,2013-10-25,25000000,16973715,71009334,46009334
Unaccompanied Minors,59,2006-12-08,25000000,16655224,21970831,-3029169
Mary Queen of Scots,60,2018-12-07,25000000,16468499,46734733,21734733
Half Past Dead,62,2002-11-15,25000000,15567860,19233280,-5766720
The Greatest Game Ever Played,65,2005-09-30,25000000,15331289,15468266,-9531734
The Box,66,2009-11-06,25000000,15051977,34356760,9356760
The Next Best Thing,67,2000-03-03,25000000,14983572,24355762,-644238
My Soul to Take,68,2010-10-08,25000000,14744435,16727470,-8272530
The Girl Next Door,69,2004-04-09,25000000,14589444,31635150,6635150
Fly Me To the Moon,70,2008-08-15,25000000,14543943,43530281,18530281
Stealing Harvard,72,2002-09-13,25000000,13973532,13973532,-11026468
Hot Rod,73,2007-08-03,25000000,13938332,14334401,-10665599
Warrior,74,2011-09-09,25000000,13657115,24215385,-784615
Battle of the Sexes,76,2017-09-22,25000000,12638526,18445379,-6554621
Cirque du Soleil: Worlds Away,77,2012-12-21,25000000,12512862,28012862,3012862
The 33,78,2015-11-13,25000000,12227722,28400715,3400715
The Conspirator,80,2011-04-15,25000000,11538204,15907411,-9092589
The Powerpuff Girls,81,2002-07-03,25000000,11411644,16425701,-8574299
The Lords of Dogtown,82,2005-06-03,25000000,11273517,13424365,-11575635
Stop-Loss,85,2008-03-28,25000000,10915744,11229035,-13770965
Abandon,87,2002-10-18,25000000,10719367,12219367,-12780633
Straw Dogs,88,2011-09-16,25000000,10324441,11253821,-13746179
Possession,90,2002-08-16,25000000,10103647,14805812,-10194188
The Road,94,2009-11-25,25000000,8114270,29206732,4206732
Beautiful Boy,95,2018-10-12,25000000,7634767,13031424,-11968576
The Hoax,96,2007-04-06,25000000,7164995,7164995,-17835005
Underclassman,99,2005-09-02,25000000,5654777,5654777,-19345223
Say It Isn't So,100,2001-03-23,25000000,5516708,5516708,-19483292
The World's Fastest Indian,1,2005-12-07,25000000,5128124,18991288,-6008712
Deception,2,2008-04-25,25000000,4598506,12850033,-12149967
King's Ransom,4,2005-04-22,25000000,4008527,4049527,-20950473
Blindness,5,2008-10-03,25000000,3073392,20052958,-4947042
Sgt. Stubby: An American Hero,6,2018-04-13,25000000,3054285,3645957,-21354043
Carnage,7,2011-12-16,25000000,2546747,38112154,13112154
Tulip Fever,8,2017-09-01,25000000,2455635,6792768,-18207232
BloodRayne,9,2006-01-06,25000000,2405420,3711633,-21288367
Legend,10,2015-11-20,25000000,1872994,42425450,17425450
Bad Lieutenant: Port of Call New Orleans,11,2009-11-20,25000000,1702112,12413949,-12586051
Jane Got a Gun,12,2016-01-29,25000000,1513793,3771345,-21228655
Me and Orson Welles,13,2009-11-25,25000000,1190003,1190003,-23809997
Venom,14,2005-09-16,25000000,881745,881745,-24118255
Where the Truth Lies,15,2005-10-14,25000000,872142,1415656,-23584344
On the Road,17,2013-03-22,25000000,720828,9313302,-15686698
Les petits mouchoirs,18,2012-08-24,25000000,205505,48530887,23530887
Love Ranch,19,2010-06-30,25000000,137885,146149,-24853851
Yi ge ren de wu lin,20,2015-04-24,25000000,129115,129115,-24870885
Sammy's avonturen: De geheime doorgang,21,2010-12-31,25000000,0,71594792,46594792
Belka i Strelka. Zvezdnye sobaki,22,2010-12-31,25000000,0,9445081,-15554919
Matilda,23,2017-12-31,25000000,0,9370285,-15629715
La vÃ©ritable histoire du Chat BottÃ©,24,2011-10-04,25000000,0,8208594,-16791406
Ironclad,25,2011-07-08,25000000,0,5297411,-19702589
Red Sky,27,2015-03-10,25000000,0,91116,-24908884
The Adventurer: The Curse of the Midas Box,29,2014-01-10,25000000,0,0,-25000000
Dangerous Liaisons,31,2012-11-09,24200000,17000,10447579,-13752421
Old School,34,2003-02-21,24000000,75155000,86765463,62765463
Rocky Balboa,35,2006-12-20,24000000,70269899,156229050,132229050
Think Like a Man Too,36,2014-06-20,24000000,65028687,70027933,46027933
Fences,37,2016-12-16,24000000,57682904,64282881,40282881
The Whole Nine Yards,38,2000-02-18,24000000,57262492,85527867,61527867
Footloose,39,2011-10-14,24000000,51802742,62989834,38989834
Going in Style,40,2017-04-07,24000000,45018541,78672579,54672579
Hitman,44,2007-11-21,24000000,39687694,99135571,75135571
Return to Me,46,2000-04-07,24000000,32662299,32662299,8662299
The Men Who Stare at Goats,47,2009-11-06,24000000,32428195,67348218,43348218
Zack and Miri Make a Porno,48,2008-10-31,24000000,31457946,36856306,12856306
Double Take,49,2001-01-12,24000000,29823162,29823162,5823162
Nurse Betty,51,2000-09-08,24000000,25170054,27732366,3732366
Piranha 3D,52,2010-08-20,24000000,25003155,83660160,59660160
Faster,53,2010-11-24,24000000,23240020,35792945,11792945
Win a Date with Tad Hamilton!,55,2004-01-23,24000000,16980098,16980098,-7019902
Ready to Rumble,57,2000-04-07,24000000,12372410,12372410,-11627590
I Don't Know How She Does It,58,2011-09-16,24000000,9659074,24474463,474463
Dhoom 3,60,2013-12-20,24000000,8031955,11723620,-12276380
Beyond the Sea,61,2004-12-17,24000000,6144806,8292914,-15707086
Hauru no ugoku shiro,62,2005-06-10,24000000,4710455,237814327,213814327
The Bridge of San Luis Rey,65,2005-06-10,24000000,49981,1696765,-22303235
Flood,66,2007-12-31,24000000,0,4084232,-19915768
Zombieland,67,2009-10-02,23600000,75590286,102236596,78636596
Green Book,71,2018-11-16,23000000,85080171,322034439,299034439
The Wedding Ringer,73,2015-01-16,23000000,64460211,80171596,57171596
Final Destination,74,2000-03-17,23000000,53302314,112036870,89036870
The Ides of March,76,2011-10-07,23000000,40962534,77735925,54735925
Pitch Black,77,2000-02-18,23000000,39235088,53182088,30182088
The Hate U Give,78,2018-10-05,23000000,29719483,35067665,12067665
Someone Like You,79,2001-03-30,23000000,27338033,38684906,15684906
Her,80,2014-01-10,23000000,25568251,48163815,25163815
Joy Ride,81,2001-10-05,23000000,21973182,21973182,-1026818
Kari gurashi no Arietti,82,2012-02-17,23000000,19192510,151496097,128496097
Haywire,83,2012-01-20,23000000,18942396,36374700,13374700
Vanity Fair,85,2004-09-01,23000000,16123851,19123851,-3876149
Eddie the Eagle,86,2016-02-26,23000000,15789389,45060480,22060480
The Crew,88,2000-08-25,23000000,13019253,13019253,-9980747
Chasing Liberty,90,2004-01-09,23000000,12189514,12291975,-10708025
The Longshots,91,2008-08-22,23000000,11511323,11778396,-11221604
In the Valley of Elah,94,2007-09-14,23000000,6777741,24489150,1489150
Coco avant Chanel,95,2009-09-25,23000000,6113834,50813834,27813834
ChÃ©ri,96,2009-06-26,23000000,2715657,2715657,-20284343
Redemption,97,2013-06-28,23000000,36686,13593473,-9406527
Rogue,98,2008-04-25,23000000,10452,4673377,-18326623
ChÄi dÃ n zhuÄnjiÄ,99,2017-05-05,23000000,0,58807172,35807172
Shi Yue Wei Cheng,100,2011-03-15,23000000,0,44195779,21195779
1408,2,2007-06-22,22500000,71985628,131263370,108763370
Nocturnal Animals,3,2016-11-18,22500000,10663357,32398681,9898681
The Water Diviner,4,2015-04-24,22500000,4200117,31054727,8554727
The Game Plan,8,2007-09-28,22000000,90648202,146590987,124590987
The Rookie,9,2002-03-29,22000000,75600072,80491516,58491516
Son of God,11,2014-02-28,22000000,59700064,70949793,48949793
The Animal,12,2001-06-01,22000000,55762229,55762229,33762229
The Hundred-Foot Journey,13,2014-08-08,22000000,54235441,94270488,72270488
Underworld,15,2003-09-19,22000000,51970690,95708457,73708457
Diary of a Wimpy Kid: Dog Days,17,2012-08-03,22000000,49008662,77229695,55229695
I Am Sam,18,2001-12-28,22000000,40270895,92542418,70542418
Derailed,19,2005-11-11,22000000,36020063,57520063,35520063
The Informant!,20,2009-09-18,22000000,33316821,41771168,19771168
Delivery Man,21,2013-11-22,22000000,30659817,70536870,48536870
"Hail, Caesar!",22,2016-02-05,22000000,30080225,64160680,42160680
Jay and Silent Bob Strike Back,23,2001-08-24,22000000,30059386,33762400,11762400
Traitor,25,2008-08-27,22000000,23530831,27882226,5882226
Deuce Bigalow: European Gigolo,26,2005-08-12,22000000,22400154,45273464,23273464
Diary of a Wimpy Kid: The Long Haul,27,2017-05-19,22000000,20738724,35609577,13609577
Mad Money,28,2008-01-18,22000000,20668843,25044057,3044057
Homefront,29,2013-11-27,22000000,20158492,51695362,29695362
Igor,30,2008-09-19,22000000,19528602,31013349,9013349
Saving Silverman,31,2001-02-09,22000000,19351569,25873142,3873142
The Glass House,33,2001-09-14,22000000,17951431,22861785,861785
The Transporter Refueled,34,2015-09-04,22000000,16029670,69698495,47698495
Josie and the Pussycats,36,2001-04-11,22000000,14252830,14252830,-7747170
Hit & Run,37,2012-08-22,22000000,13749300,17216955,-4783045
The Little Vampire,38,2000-10-27,22000000,13555988,13555988,-8444012
I Heart Huckabees,39,2004-10-01,22000000,12784713,20034713,-1965287
"Roman J. Israel, Esq.",40,2017-11-17,22000000,11962712,12967012,-9032988
Out of the Furnace,41,2013-12-04,22000000,11330849,15434375,-6565625
Just Getting Started,44,2017-12-08,22000000,6069605,6756412,-15243588
Megiddo: Omega Code 2,45,2001-09-21,22000000,6047691,6047691,-15952309
The Libertine,47,2005-11-23,22000000,4835065,9448623,-12551377
Zwartboek,48,2007-04-06,22000000,4398532,27238354,5238354
Before I Go to Sleep,49,2014-10-31,22000000,3242457,19563579,-2436421
Stone,50,2010-10-08,22000000,1810078,4065020,-17934980
Joyeux NoÃ«l,51,2006-03-03,22000000,1054361,23134075,1134075
Metegol,52,2013-12-31,22000000,0,34061097,12061097
MoliÃ¨re,54,2007-07-27,21600000,635733,791154,-20808846
Michael Clayton,55,2007-10-05,21500000,49033882,92987651,71487651
To Rome with Love,58,2012-06-22,21500000,16684352,74326015,52826015
Silver Linings Playbook,59,2012-11-16,21000000,132092958,236412453,215412453
Blockers,60,2018-04-06,21000000,60311495,94045328,73045328
Death at a Funeral,64,2010-04-16,21000000,42739347,48977233,27977233
Hardball,66,2001-09-14,21000000,40222729,43728560,22728560
For Colored Girls,67,2010-11-05,21000000,37729698,38017873,17017873
Freedom Writers,68,2007-01-05,21000000,36605602,43632609,22632609
Kidnap,69,2017-08-04,21000000,30718107,34836080,13836080
The Transporter,70,2002-10-11,21000000,25296447,43928932,22928932
Never Back Down,71,2008-03-14,21000000,24850922,39319801,18319801
Tinker Tailor Soldier Spy,72,2011-12-09,21000000,24149393,81452811,60452811
Victoria and Abdul,73,2017-09-22,21000000,22245070,68271146,47271146
Swing Vote,76,2008-08-01,21000000,16289867,17589867,-3410133
Away We Go,77,2009-06-05,21000000,9451946,10108016,-10891984
Moonlight Mile,78,2002-09-27,21000000,6830957,6830957,-14169043
The Beaver,79,2011-05-06,21000000,970816,5046038,-15953962
Bitter Harvest,80,2017-02-24,21000000,557241,606162,-20393838
Pulse,85,2006-08-11,20500000,20264436,30241435,9741435
La La Land,92,2016-12-09,20000000,151101803,426351163,406351163
The Conjuring,93,2013-07-19,20000000,137400141,318000141,298000141
Bringing Down the House,94,2003-03-07,20000000,132675402,164675402,144675402
Wonder,95,2017-11-17,20000000,132422809,304604712,284604712
Jackass 3D,98,2010-10-15,20000000,117229692,171685793,151685793
Bad Moms,99,2016-07-29,20000000,113257297,180998716,160998716
Beverly Hills Chihuahua,2,2008-10-03,20000000,94514402,154218168,134218168
Tammy,3,2014-07-02,20000000,84525432,96407655,76407655
Are We There Yet?,4,2005-01-21,20000000,82674398,98114471,78114471
The Descendants,5,2011-11-16,20000000,82624961,175507800,155507800
School of Rock,6,2003-10-03,20000000,81261177,131944672,111944672
Disturbia,7,2007-04-13,20000000,80818974,118537627,98537627
Tyler Perryâs Boo! A Madea Halloween,9,2016-10-21,20000000,73206343,73206343,53206343
White Chicks,11,2004-06-23,20000000,69148997,111448997,91448997
Obsessed,12,2009-04-24,20000000,68261644,73964713,53964713
Holes,13,2003-04-18,20000000,67383924,71232214,51232214
Tyler Perry's Madea's Witness Protection,14,2012-06-29,20000000,65653242,66950887,46950887
The Last Song,15,2010-03-31,20000000,62950384,92678948,72678948
Why Did I Get Married Too?,16,2010-04-02,20000000,60095852,60831067,40831067
12 Years a Slave,18,2013-10-18,20000000,56671993,181025343,161025343
Drumline,19,2002-12-13,20000000,56398162,56398162,36398162
Me Before You,20,2016-06-03,20000000,56245075,208265198,188265198
Barbershop: The Next Cut,22,2016-04-15,20000000,54030051,54404202,34404202
A Simple Favor,24,2018-09-14,20000000,53548586,97628717,77628717
Selma,25,2015-01-09,20000000,52076908,66776576,46776576
Date Movie,27,2006-02-17,20000000,48548426,85146165,65146165
Peter Pan: Return to Neverland,28,2002-02-15,20000000,48430258,109862682,89862682
The Jungle Book 2,29,2003-02-14,20000000,47901582,140122225,120122225
Premonition,30,2007-03-16,20000000,47852604,81461343,61461343
Tyler Perryâs Boo 2! A Madea Halloween,31,2017-10-20,20000000,47319572,47879572,27879572
Boogeyman,32,2005-02-04,20000000,46752382,67192859,47192859
The Tigger Movie,33,2000-02-11,20000000,45542421,96147688,76147688
Spotlight,34,2015-11-06,20000000,45055776,92088460,72088460
Acrimony,35,2018-03-30,20000000,43549096,46627836,26627836
Max,36,2015-06-26,20000000,42656255,43658157,23658157
Meet the Browns,37,2008-03-21,20000000,41975388,41975388,21975388
Orphan,38,2009-07-24,20000000,41596251,78769428,58769428
The Star,39,2017-11-17,20000000,40847995,62758010,42758010
Epic Movie,40,2007-01-26,20000000,39739367,86858578,66858578
Lakeview Terrace,41,2008-09-19,20000000,39263506,44821299,24821299
The Grudge 2,42,2006-10-13,20000000,39143839,70743839,50743839
Nerve,43,2016-07-27,20000000,38583626,70652284,50652284
Man of the Year,47,2006-10-13,20000000,37442180,41342180,21342180
Risen,48,2016-02-19,20000000,36880033,46255763,26255763
Vampires Suck,49,2010-08-18,20000000,36661504,81424988,61424988
The American,51,2010-09-01,20000000,35606376,67950723,47950723
A Very Harold & Kumar 3D Christmas,53,2011-11-04,20000000,35061031,36265745,16265745
Eternal Sunshine of the Spotless Mind,54,2004-03-19,20000000,34366518,72570762,52570762
Texas Chainsaw 3D,55,2013-01-04,20000000,34341945,47666013,27666013
Babel,56,2006-10-27,20000000,34302837,132121212,112121212
This is Where I Leave You,57,2014-09-19,20000000,34296320,41296320,21296320
Doubt,58,2008-12-12,20000000,33446470,53191101,33191101
Team America: World Police,59,2004-10-15,20000000,32774834,50948811,30948811
Scary Movie V,61,2013-04-12,20000000,32015787,78613981,58613981
She's Out of My League,62,2010-03-12,20000000,32010860,48680977,28680977
Milk,63,2008-11-26,20000000,31841299,57293371,37293371
The Debt,65,2011-08-31,20000000,31177548,46604054,26604054
Ghost Ship,66,2002-10-25,20000000,30113491,68349884,48349884
Daybreakers,67,2010-01-08,20000000,30101577,51445503,31445503
The Bank Job,68,2008-03-07,20000000,30060660,66143005,46143005
The Stepfather,70,2009-10-16,20000000,29062561,29227561,9227561
High Fidelity,71,2000-03-31,20000000,27277055,47881663,27881663
Stick It,72,2006-04-28,20000000,26910736,30399714,10399714
One Missed Call,73,2008-01-04,20000000,26890041,44513466,24513466
Street Kings,75,2008-04-11,20000000,26418667,65457811,45457811
The World's End,76,2013-08-23,20000000,26004851,47508505,27508505
You Again,78,2010-09-24,20000000,25702053,32838945,12838945
Nancy Drew,79,2007-06-15,20000000,25584685,30703845,10703845
Alpha and Omega 3D,80,2010-09-17,20000000,25107267,48958353,28958353
On the Basis of Sex,81,2018-12-25,20000000,24622687,38073377,18073377
Endless Love,82,2014-02-14,20000000,23438250,34718173,14718173
The Covenant,83,2006-09-08,20000000,23364784,38164784,18164784
Monte Carlo,84,2011-07-01,20000000,23186769,39686769,19686769
Stay Alive,85,2006-03-24,20000000,23086480,23187506,3187506
2 For the Money,86,2005-10-07,20000000,22991379,30491379,10491379
Rough Night,87,2017-06-16,20000000,22105643,46844357,26844357
Shorts,91,2009-08-21,20000000,20919166,29870801,9870801
Appaloosa,93,2008-09-19,20000000,20211394,27911453,7911453
Secret in Their Eyes,94,2015-11-20,20000000,20180155,32608019,12608019
Yu-Gi-Oh,95,2004-08-13,20000000,19762690,28762690,8762690
Reign Over Me,96,2007-03-23,20000000,19661987,20081987,81987
My Best Friend's Girl,97,2008-09-19,20000000,19219250,34787111,14787111
Georgia Rule,98,2007-05-11,20000000,18882880,20819601,819601
Into the Wild,1,2007-09-21,20000000,18354356,56822960,36822960
Pooh's Heffalump Movie,3,2005-02-11,20000000,18098433,55686944,35686944
School for Scoundrels,4,2006-09-29,20000000,17807569,17807569,-2192431
Silent Hill: Revelation 3D,5,2012-10-26,20000000,17530219,55975672,35975672
The Zookeeperâs Wife,7,2017-03-31,20000000,17445186,26308749,6308749
Fired Up,8,2009-02-20,20000000,17231291,18608570,-1391430
Kung Fu Hustle,9,2005-04-08,20000000,17104669,102034104,82034104
The Country Bears,10,2002-07-26,20000000,16988996,16988996,-3011004
Flatliners,11,2017-09-29,20000000,16883115,45173738,25173738
Dead Silence,12,2007-03-16,20000000,16574590,20614661,614661
21 Grams,13,2003-11-21,20000000,16248701,59667625,39667625
Armored,14,2009-12-04,20000000,15988876,23661038,3661038
The Kite Runner,15,2007-12-14,20000000,15800078,74180745,54180745
Paparazzi,16,2004-09-03,20000000,15712072,16612072,-3387928
A Guy Thing,17,2003-01-17,20000000,15543862,17430594,-2569406
Loser,19,2000-07-21,20000000,15464026,18250106,-1749894
Capitalism: A Love Story,21,2009-09-23,20000000,14363397,19121531,-878469
Lockout,22,2012-04-13,20000000,14326865,33943049,13943049
Disaster Movie,23,2008-08-29,20000000,14190901,36720752,16720752
What's Your Number?,24,2011-09-30,20000000,14011084,30163785,10163785
Crank 2: High Voltage,26,2009-04-17,20000000,13684249,35472739,15472739
Burnt,27,2015-10-30,20000000,13651946,36773510,16773510
Envy,28,2004-04-30,20000000,13548322,14566246,-5433754
One Night with the King,29,2006-10-13,20000000,13395961,13725032,-6274968
Ghost Town,31,2008-09-19,20000000,13367624,29958228,9958228
The Quiet American,32,2002-11-22,20000000,12987647,26348203,6348203
Triple 9,33,2016-02-26,20000000,12639297,25943792,5943792
The Light Between Oceans,34,2016-09-02,20000000,12545979,22281732,2281732
The Weather Man,35,2005-10-28,20000000,12482775,15466961,-4533039
Undisputed,36,2002-08-23,20000000,12398628,12398628,-7601372
12 Rounds,37,2009-03-27,20000000,12234694,17306648,-2693352
Let Me In,38,2010-10-01,20000000,12134935,28270399,8270399
Be Kind Rewind,40,2008-02-22,20000000,11175164,30894247,10894247
Mrs. Henderson Presents,41,2005-12-09,20000000,11036366,27836366,7836366
Death Sentence,46,2007-08-31,20000000,9534258,16907831,-3092169
Popstar: Never Stop Never Stopping,47,2016-06-03,20000000,9496130,9537120,-10462880
Thank You for Your Service,48,2017-10-27,20000000,9479390,9985316,-10014684
Everybody's Fine,49,2009-12-04,20000000,9208876,9208876,-10791124
Superbabies: Baby Geniuses 2,50,2004-08-27,20000000,9109322,9355369,-10644631
Battle of the Year,51,2013-09-20,20000000,8888355,16723377,-3276623
Ratchet and Clank,52,2016-04-29,20000000,8813410,14365639,-5634361
Death at a Funeral,53,2007-08-17,20000000,8580428,46790428,26790428
The Man,54,2005-09-09,20000000,8330720,10393696,-9606304
Code Name: The Cleaner,55,2007-01-05,20000000,8135024,8135024,-11864976
Inherent Vice,56,2014-12-12,20000000,8110975,14772346,-5227654
Connie & Carla,57,2004-04-16,20000000,8047525,8047525,-11952475
Machete Kills,58,2013-10-11,20000000,8008161,18273009,-1726991
Doogal,60,2006-02-24,20000000,7578946,28058652,8058652
Proof,61,2005-09-16,20000000,7535331,8284331,-11715669
An American Carol,62,2008-10-03,20000000,7013191,7022183,-12977817
Willard,63,2003-03-14,20000000,6882696,6882696,-13117304
Strange Wilderness,64,2008-02-01,20000000,6575282,6947084,-13052916
Little Boy,65,2015-04-24,20000000,6485961,17769299,-2230701
Chasing Mavericks,67,2012-10-26,20000000,6002756,8300821,-11699179
A Most Violent Year,68,2014-12-31,20000000,5749134,8846875,-11153125
A Dangerous Method,69,2011-11-23,20000000,5702083,14807531,-5192469
A Scanner Darkly,70,2006-07-07,20000000,5501616,7405084,-12594916
Bandslam,71,2009-08-14,20000000,5210988,12967829,-7032171
Alone in the Dark,72,2005-01-28,20000000,5178569,10588079,-9411921
Birth,73,2004-10-29,20000000,5005899,14603001,-5396999
Hands of Stone,74,2016-08-26,20000000,4712792,5031975,-14968025
Passchendaele,75,2008-10-24,20000000,4452423,4453327,-15546673
Flash of Genius,76,2008-10-03,20000000,4442377,4504111,-15495889
Iâm Not There,77,2007-11-21,20000000,4017609,12397613,-7602387
The Cold Light of Day,78,2012-09-07,20000000,3763583,25361206,5361206
The Brothers Bloom,79,2009-05-15,20000000,3531756,5531756,-14468244
"Synecdoche, New York",80,2008-10-24,20000000,3083538,4383538,-15616462
Suspiria,81,2018-10-26,20000000,2483472,7034615,-12965385
LBJ,82,2017-11-03,20000000,2468683,2507181,-17492819
Bon Voyage,84,2004-03-19,20000000,2353728,8361736,-11638264
My All-American,85,2015-11-13,20000000,2246000,2246000,-17754000
The Proposition,87,2006-05-05,20000000,1903434,5313608,-14686392
Marci X,88,2003-08-22,20000000,1646664,1646664,-18353336
Equilibrium,89,2002-12-06,20000000,1190018,5345869,-14654131
Dylan Dog: Dead of Night,90,2011-04-29,20000000,1186538,6093725,-13906275
The Oogieloves in the BIG Balloon Adventure,91,2012-08-29,20000000,1065907,1065907,-18934093
The Children of Huang Shi,92,2008-05-23,20000000,1031872,8221700,-11778300
The Yards,93,2000-10-20,20000000,882710,2282710,-17717290
Middle Men,94,2010-08-06,20000000,754301,754301,-19245699
JÃ¬yÃ¬ dÃ shÄ«,95,2017-04-28,20000000,587470,43888531,23888531
All Good Things,96,2010-12-03,20000000,582024,873617,-19126383
By the Sea,97,2015-11-13,20000000,538460,3727746,-16272254
Steamboy,98,2005-03-18,20000000,468867,10468867,-9531133
The Game of Their Lives,99,2005-04-22,20000000,375474,375474,-19624526
The Tempest,1,2010-12-10,20000000,277943,277943,-19722057
é·æ±ä¸è (CJ7),2,2008-03-07,20000000,206678,47300771,27300771
The Burning Plain,3,2009-09-18,20000000,200730,1167092,-18832908
People I Know,5,2003-04-25,20000000,121972,5694213,-14305787
Regression,6,2015-10-30,20000000,55039,15824374,-4175626
Admiral,7,2008-12-31,20000000,0,38585047,18585047
Zambezia,8,2012-12-31,20000000,0,34454336,14454336
Three Kingdoms: Resurrection of the Dragon,9,2010-04-13,20000000,0,22139590,2139590
The Touch,10,2004-03-31,20000000,0,5918742,-14081258
Survivor,11,2015-05-29,20000000,0,1703281,-18296719
The History of Love,12,2016-11-18,20000000,0,476624,-19523376
Butterfly on a Wheel,13,2007-12-25,20000000,0,0,-20000000
Dwegons and Leprechauns,14,2014-08-29,20000000,0,0,-20000000
Fight Valley,15,2016-07-22,20000000,0,0,-20000000
The Thousand Miles,16,2017-12-31,20000000,0,0,-20000000
Bird Box,17,2018-12-13,19800000,0,0,-19800000
Der Baader Meinhof Komplex,18,2009-08-21,19700000,476270,16498827,-3201173
The Shape of Water,19,2017-12-01,19500000,63859435,195790794,176290794
De rouille et dâos,20,2012-11-23,19500000,2061449,29393634,9893634
The Painted Veil,21,2006-12-20,19400000,8060487,15118795,-4281205
The Frozen Ground,22,2013-08-23,19200000,0,5617460,-13582540
The Devil's Double,23,2011-07-29,19100000,1361512,5965646,-13134354
Scary Movie,26,2000-07-07,19000000,157019771,277200000,258200000
Bad Teacher,27,2011-06-24,19000000,100292856,215448997,196448997
Sausage Party,28,2016-08-12,19000000,97670358,141344255,122344255
Just Married,30,2003-01-10,19000000,56127162,101564935,82564935
I Can Do Bad All By Myself,31,2009-09-11,19000000,51733921,51733921,32733921
A Cinderella Story,32,2004-07-16,19000000,51438175,70164105,51164105
Thirteen Ghosts,34,2001-10-26,19000000,41867960,68467960,49467960
The Crazies,36,2010-02-26,19000000,39123589,56445534,37445534
Notorious,37,2009-01-16,19000000,36843682,44972183,25972183
Nobodyâs Fool,38,2018-11-02,19000000,31713110,32589493,13589493
The Switch,39,2010-08-20,19000000,27758465,49858465,30858465
Leap Year,40,2010-01-08,19000000,25918920,32618920,13618920
The Book Thief,41,2013-11-08,19000000,21488481,76086711,57086711
"Gone, Baby, Gone",42,2007-10-19,19000000,20300218,34352162,15352162
Thomas and the Magic Railroad,43,2000-07-26,19000000,15911332,15911332,-3088668
Sen to Chihiro no Kamikakushi,45,2002-09-20,19000000,10049886,274949886,255949886
Sex Drive,46,2008-10-17,19000000,8402485,10412485,-8587515
Take Me Home Tonight,48,2011-03-04,19000000,6928068,7576604,-11423396
Won't Back Down,49,2012-09-28,19000000,5310554,5745503,-13254497
Action Point,50,2018-06-01,19000000,5059608,5103675,-13896325
George Balanchine\'s The Nutcracker,53,2011-12-13,19000000,2119994,2119994,-16880006
Out of the Inferno,55,2016-03-08,19000000,0,0,-19000000
George A. Romero's Land of the Dead,56,2005-06-24,18975000,20700082,47751015,28776015
IndigÃ¨nes,57,2006-12-15,18900000,320700,26063572,7163572
The Amityville Horror,58,2005-04-15,18500000,65233369,109175673,90675673
Adaptation,59,2002-12-06,18500000,22498520,32531759,14031759
The Invention of Lying,60,2009-10-02,18500000,18451251,32679264,14179264
Ne le dis Ã personne,62,2008-07-04,18500000,6198883,33954018,15454018
Left Behind,63,2001-02-02,18500000,4221341,4221341,-14278659
Neighbors,64,2014-05-09,18000000,150086800,270944428,252944428
Borat,65,2006-11-03,18000000,128505958,261443242,243443242
Legally Blonde,68,2001-07-13,18000000,96493426,141809235,123809235
Mean Girls,69,2004-04-30,18000000,86047227,130953026,112953026
The Exorcism of Emily Rose,71,2005-09-09,18000000,75072454,144529078,126529078
Barbershop 2: Back in Business,73,2004-01-01,18000000,65070412,65842412,47842412
The Family Stone,74,2005-12-16,18000000,60062868,92357499,74357499
Bad Santa,75,2003-11-26,18000000,60060328,77147031,59147031
My Big Fat Greek Wedding 2,77,2016-03-25,18000000,59689605,92096558,74096558
The Perfect Guy,78,2015-09-11,18000000,57027435,60278166,42278166
Diary of a Wimpy Kid: Rodrick Rules,80,2011-03-25,18000000,52698535,73695194,55695194
Prom Night,82,2008-04-11,18000000,43869350,57193655,39193655
Soul Surfer,83,2011-04-08,18000000,43853424,47158652,29158652
Under the Tuscan Sun,84,2003-09-26,18000000,43601508,57490024,39490024
Uncle Drew,85,2018-06-29,18000000,42469946,46527161,28527161
Birdman or (The Unexpected Virtue of Ignorance),86,2014-10-17,18000000,42340598,103215094,85215094
Gosford Park,88,2001-12-26,18000000,41300105,41300105,23300105
Orange County,89,2002-01-11,18000000,41059716,43308707,25308707
Blue Jasmine,90,2013-07-26,18000000,33404871,102912961,84912961
United 93,91,2006-04-28,18000000,31567134,77635035,59635035
Honey,92,2003-12-05,18000000,30272254,62646763,44646763
The Fog,93,2005-10-14,18000000,29511112,37048526,19048526
Ricki and the Flash,95,2015-08-07,18000000,26839498,41166033,23166033
Love the Coopers,98,2015-11-13,18000000,26302731,42227490,24227490
Observe and Report,100,2009-04-10,18000000,24007324,27148898,9148898
Love Happens,2,2009-09-18,18000000,22965110,36133014,18133014
Fame,3,2009-09-25,18000000,22455510,80227619,62227619
The Circle,4,2017-04-28,18000000,20497844,40651864,22651864
127 Hours,6,2010-11-05,18000000,18335230,60217171,42217171
Small Time Crooks,7,2000-05-19,18000000,17266359,29934477,11934477
Center Stage,8,2000-05-12,18000000,17200925,21361109,3361109
Norm of the North,9,2016-01-15,18000000,17062499,30535660,12535660
Catch That Kid,10,2004-02-06,18000000,16703799,16959614,-1040386
Jobs,11,2013-08-16,18000000,16131410,43402515,25402515
Life as a House,12,2001-10-26,18000000,15652637,23889158,5889158
Youth in Revolt,13,2010-01-08,18000000,15285588,19685588,1685588
And So It Goes,14,2014-07-25,18000000,15160801,17920013,-79987
"I Love You, Beth Cooper",15,2009-07-10,18000000,14800725,16382538,-1617462
The Tailor of Panama,17,2001-03-30,18000000,13491653,27491653,9491653
Labor Day,19,2014-01-31,18000000,13371528,14189810,-3810190
Getaway,20,2013-08-30,18000000,10501938,11813989,-6186011
Being Julia,22,2004-10-15,18000000,7739049,14488705,-3511295
The Last Station,25,2010-01-15,18000000,6617867,15696146,-2303854
Mongol,28,2008-06-06,18000000,5705761,27147349,9147349
RocknRolla,29,2008-10-08,18000000,5700626,27794339,9794339
Mao's Last Dancer,31,2010-08-20,18000000,4806750,25941437,7941437
The Railway Man,33,2014-04-11,18000000,4438438,23910210,5910210
Midnight Special,35,2016-03-18,18000000,3712282,7680250,-10319750
Miss Sloane,36,2016-11-25,18000000,3500605,7719630,-10280370
Metallica Through the Never,37,2013-09-27,18000000,3419967,9082906,-8917094
Anything Else,38,2003-09-19,18000000,3203044,13203044,-4796956
T2: Trainspotting,40,2017-03-17,18000000,2402004,42091262,24091262
Das Weisse Band: Eine deutsche Kindergeschichte,41,2009-12-30,18000000,2222862,25727044,7727044
Phantom,43,2013-03-01,18000000,1034589,1199510,-16800490
The Salton Sea,44,2002-04-26,18000000,676698,676698,-17323302
The Informers,45,2009-04-24,18000000,315000,315000,-17685000
Carlos,47,2010-10-15,18000000,145526,1619153,-16380847
Renaissance,48,2006-09-22,18000000,70644,2401413,-15598587
I Come with the Rain,49,2008-12-31,18000000,0,627422,-17372578
I Am Wrath,50,2016-04-15,18000000,0,309608,-17690392
Wolves,51,2014-11-14,18000000,0,94953,-17905047
Day of the Dead,52,2008-04-08,18000000,0,0,-18000000
The Prince,53,2014-08-22,18000000,0,0,-18000000
Forsaken,54,2016-02-19,18000000,0,0,-18000000
Red Lights,56,2012-07-13,17700000,49521,14518884,-3181116
Superbad,57,2007-08-17,17500000,121463226,169955142,152455142
Madea Goes To Jail,58,2009-02-20,17500000,90508336,90508336,73008336
Step Up 2 the Streets,59,2008-02-14,17500000,58017783,148586910,131086910
Hoodwinked,60,2006-01-13,17500000,51386611,109843390,92343390
Hotel Rwanda,61,2004-12-22,17500000,23519128,36521223,19021223
Beerfest,62,2006-08-25,17500000,19185184,20159316,2659316
Black Nativity,63,2013-11-27,17500000,7018188,7285135,-10214865
City of Ghosts,64,2003-04-25,17500000,325491,325491,-17174509
Taxi 4,65,2007-12-31,17500000,0,60865364,43365364
A Quiet Place,66,2018-04-06,17000000,188024361,334522294,317522294
The Others,67,2001-08-10,17000000,96522687,207765056,190765056
Letâs Be Cops,69,2014-08-13,17000000,82390774,136890774,119890774
Sideways,72,2004-10-22,17000000,71502303,109793192,92793192
The Best Man Holiday,73,2013-11-15,17000000,70525195,72835710,55835710
Friday the 13th,74,2009-02-13,17000000,65002019,92670237,75670237
Pitch Perfect,75,2012-09-28,17000000,65001093,116044347,99044347
Evil Dead,77,2013-04-05,17000000,54239856,97778356,80778356
Jet Li's Hero,78,2004-08-27,17000000,53652140,177535958,160535958
Saw 3D,79,2010-10-29,17000000,45710178,133735284,116735284
"McFarland, USA",80,2015-02-20,17000000,44480275,45707924,28707924
Almost Christmas,81,2016-11-11,17000000,42065185,42493506,25493506
The Hills Have Eyes,82,2006-03-10,17000000,41778863,70355813,53355813
40 Days and 40 Nights,83,2002-03-01,17000000,37939782,95092667,78092667
Good Boy!,84,2003-10-10,17000000,37667746,45312217,28312217
Smokin' Aces,85,2007-01-26,17000000,35662731,57263440,40263440
Beastly,87,2011-03-04,17000000,27865571,38028230,21028230
Brooklyn's Finest,88,2010-03-05,17000000,27163593,39233233,22233233
Lottery Ticket,90,2010-08-20,17000000,24719879,24719879,7719879
Dickie Roberts: Former Child Star,91,2003-09-05,17000000,22734486,23734486,6734486
ATL,92,2006-03-31,17000000,21170563,21170563,4170563
Summer Catch,93,2001-08-24,17000000,19693891,19693891,2693891
Larry the Cable Guy: Health Inspector,95,2006-03-24,17000000,15680099,15680099,-1319901
Wes Craven Presents: They,96,2002-11-27,17000000,12840842,16140842,-859158
My Life in Ruins,100,2009-06-05,17000000,8677425,20477425,3477425
American Dreamz,1,2006-04-21,17000000,7314027,16510971,-489029
How She Move,2,2008-01-25,17000000,7070641,8607815,-8392185
Running Scared,3,2006-02-24,17000000,6855137,9729088,-7270912
The Apparition,4,2012-08-24,17000000,4936819,10637281,-6362719
Bobby Jones: Stroke of Genius,5,2004-04-30,17000000,2694071,2694071,-14305929
L'illusionniste,7,2010-12-25,17000000,2231474,8609949,-8390051
Veronica Guerin,9,2003-10-17,17000000,1569918,9438074,-7561926
Genius,10,2016-06-10,17000000,1361045,7265283,-9734717
Southland Tales,11,2007-11-14,17000000,275380,364607,-16635393
Escobar: Paradise Lost,12,2015-06-26,17000000,195792,3917679,-13082321
"Mune, le gardien de la lune",13,2017-09-26,17000000,0,14534046,-2465954
Chasseurs de dragons,14,2009-06-23,17000000,0,13446115,-3553885
The Young Messiah,17,2016-03-11,16800000,6469813,7313697,-9486303
FUR: An Imaginary Portrait of Diane Arbus,18,2006-11-10,16800000,223202,2281089,-14518911
The Illusionist,22,2006-08-18,16500000,39868642,83792062,67292062
Becoming Jane,23,2007-08-03,16500000,18663911,39380876,22880876
House of Sand and Fog,24,2003-12-19,16500000,13005485,16157923,-342077
Sydney White,25,2007-09-21,16500000,11892415,13636339,-2863661
Arn - Tempelriddaren,26,2007-12-31,16500000,0,21404122,4904122
Road Trip,30,2000-05-19,16000000,68525609,119739110,103739110
Moonrise Kingdom,33,2012-05-25,16000000,45512466,68848446,52848446
The Artist,34,2011-11-25,16000000,44667095,128256712,112256712
The Unborn,35,2009-01-09,16000000,42670410,78208812,62208812
The Master of Disguise,36,2002-08-02,16000000,40363530,40363530,24363530
The Texas Chainsaw Massacre: The Beginning,37,2006-10-06,16000000,39517763,50517763,34517763
El Laberinto del Fauno,38,2006-12-29,16000000,37634615,87041569,71041569
The Roommate,39,2011-02-04,16000000,37300107,52545707,36545707
The Messengers,40,2007-02-02,16000000,35374833,53774833,37774833
See Spot Run,41,2001-03-02,16000000,33357476,43057552,27057552
Baby Boy,43,2001-06-27,16000000,28734552,28734552,12734552
Joe Dirt,44,2001-04-11,16000000,27087695,30987695,14987695
The Women,45,2008-09-12,16000000,26902075,50103808,34103808
Hot Fuzz,46,2007-04-20,16000000,23618786,81742618,65742618
Vicky Cristina Barcelona,47,2008-08-15,16000000,23216709,104504817,88504817
Boys and Girls,48,2000-06-16,16000000,21799652,21799652,5799652
Superfly,49,2018-06-13,16000000,20537137,20723581,4723581
Remember Me,51,2010-03-12,16000000,19068240,56506120,40506120
White Oleander,52,2002-10-11,16000000,16357770,21657770,5657770
Jennifer's Body,53,2009-09-18,16000000,16204793,31943401,15943401
Drowning Mona,54,2000-03-03,16000000,15427192,15980376,-19624
How to Deal,56,2003-07-18,16000000,14108518,14108518,-1891482
Left Behind,57,2014-10-03,16000000,14019924,20769209,4769209
Soul Plane,58,2004-05-28,16000000,13922211,14553807,-1446193
People Like Us,60,2012-06-29,16000000,12431792,12617472,-3382528
The Cookout,62,2004-09-03,16000000,11540112,11540112,-4459888
Bleed for This,65,2016-11-18,16000000,5083906,6603926,-9396074
Hollywood Ending,66,2002-05-03,16000000,4839383,14839383,-1160617
Duets,67,2000-09-15,16000000,4734235,6615452,-9384548
Things We Lost in the Fire,69,2007-10-19,16000000,3287315,8120148,-7879852
The Homesman,70,2014-11-14,16000000,2429989,8217571,-7782429
Trance,71,2013-04-05,16000000,2322593,22594052,6594052
The Immigrant,72,2014-05-16,16000000,2013456,7585011,-8414989
The White Countess,74,2005-12-21,16000000,1669971,2814566,-13185434
Bienvenue chez les Ch'tis,75,2008-07-25,16000000,1477650,247474497,231474497
"Men, Women and Children",76,2014-10-01,16000000,705908,1685403,-14314597
Enter the Void,77,2010-09-24,16000000,337997,1467278,-14532722
Good,78,2008-12-31,16000000,31631,31631,-15968369
Vamps,79,2012-11-02,16000000,3361,94812,-15905188
Haeundae,80,2010-05-11,16000000,0,64733391,48733391
Hachiko: A Dog's Story,81,2010-03-09,16000000,0,47707417,31707417
Zulu,82,2013-12-31,16000000,0,1844228,-14155772
Second Act,83,2018-12-21,15700000,39282227,63288854,47588854
Juwanna Mann,84,2002-06-21,15600000,13571817,13771817,-1828183
La MÃ´me,85,2007-06-08,15500000,10299782,88611837,73111837
Ararat,86,2002-11-15,15500000,1693000,1693000,-13807000
Slow Burn,87,2007-04-13,15500000,1237615,1237615,-14262385
Madison,88,2005-04-22,15500000,517262,517262,-14982738
The Yellow Handkerchief,89,2010-02-26,15500000,318623,318623,-15181377
Wasabi,90,2002-09-27,15300000,81525,7000000,-8300000
Slither,91,2006-03-31,15250000,7802450,12930343,-2319657
The Kingâs Speech,97,2010-11-26,15000000,138797449,430821168,415821168
"Crouching Tiger, Hidden Dragon",99,2000-12-08,15000000,128067808,213514672,198514672
Annabelle: Creation,2,2017-08-11,15000000,102092201,305384865,290384865
Jackass Presents: Bad Grandpa,3,2013-10-25,15000000,102003019,160903019,145903019
The Imitation Game,6,2014-11-28,15000000,91125143,227740463,212740463
Mama,9,2013-01-18,15000000,71628180,148095566,133095566
Diary of a Wimpy Kid,13,2010-03-19,15000000,64003625,76954311,61954311
Halloween,15,2007-08-31,15000000,58269151,77514401,62514401
The Queen,16,2006-09-30,15000000,56441711,128885873,113885873
Why Did I Get Married?,17,2007-10-12,15000000,55204525,55934178,40934178
The Woman in Black,18,2012-02-03,15000000,54333290,128955898,113955898
BlacKkKlansman,21,2018-08-10,15000000,49275340,93017335,78017335
When a Stranger Calls,22,2006-02-03,15000000,47860214,67215435,52215435
Big Fat Liar,23,2002-02-08,15000000,47811275,52461017,37461017
Snitch,26,2013-02-22,15000000,42930462,57907734,42907734
The Lizzie McGuire Movie,27,2003-05-02,15000000,42734455,55534455,40534455
Krampus,28,2015-12-04,15000000,42725475,61788393,46788393
End of Watch,29,2012-09-21,15000000,41003371,57586606,42586606
Not Another Teen Movie,32,2001-12-14,15000000,37882551,62401343,47401343
Wild,33,2014-12-03,15000000,37880356,52460543,37460543
The Theory of Everything,35,2014-11-07,15000000,35893537,123327692,108327692
Drive,36,2011-09-16,15000000,35060689,81357930,66357930
The Skulls,37,2000-03-31,15000000,35007180,35007180,20007180
The Favourite,39,2018-11-23,15000000,34366783,94113929,79113929
Malibu's Most Wanted,40,2003-04-18,15000000,34308901,34499204,19499204
All About Steve,41,2009-09-04,15000000,33862903,40127259,25127259
Where the Heart Is,42,2000-04-28,15000000,33771174,40862054,25862054
Halloween 2,43,2009-08-28,15000000,33392973,38512850,23512850
The Last House on the Left,44,2009-03-13,15000000,32752215,46526243,31526243
Because of Winn-Dixie,45,2005-02-18,15000000,32647042,33508485,18508485
The Wedding Date,46,2005-02-04,15000000,31726995,47175038,32175038
Halloween: Resurrection,48,2002-07-12,15000000,30259652,37659652,22659652
The Great Debaters,49,2007-12-25,15000000,30226144,30261293,15261293
When the Game Stands Tall,50,2014-08-22,15000000,30127963,30138912,15138912
Confessions of a Teenage Drama Queen,52,2004-02-20,15000000,29331068,33118854,18118854
28 Weeks Later,54,2007-05-11,15000000,28638916,64232714,49232714
Love and Basketball,56,2000-04-21,15000000,27441122,27709625,12709625
Home Again,57,2017-09-08,15000000,27020284,37336874,22336874
Book of Shadows: Blair Witch 2,58,2000-10-27,15000000,26421314,47721314,32721314
Ramona and Beezus,60,2010-07-23,15000000,26167002,27469621,12469621
The November Man,61,2014-08-27,15000000,25018119,34820335,19820335
Match Point,63,2005-12-28,15000000,23089926,87973835,72973835
Urban Legends: Final Cut,66,2000-09-22,15000000,21468807,38574362,23574362
The Place Beyond the Pines,67,2013-03-29,15000000,21403519,47011449,32011449
Flicka,68,2006-10-20,15000000,21000147,21896367,6896367
The Hills Have Eyes II,69,2007-03-23,15000000,20804166,37466538,22466538
Keanu,70,2016-04-29,15000000,20591853,20688141,5688141
Country Strong,71,2010-12-22,15000000,20218921,20601987,5601987
Tuck Everlasting,72,2002-10-11,15000000,19161999,19344615,4344615
The Marine,73,2006-10-13,15000000,18844784,22165608,7165608
A Most Wanted Man,76,2014-07-25,15000000,17237855,36068890,21068890
The Hurt Locker,77,2009-06-26,15000000,17017811,49894223,34894223
Eye of the Beholder,78,2000-01-28,15000000,16500786,18260865,3260865
The Man with the Iron Fists,79,2012-11-02,15000000,15634090,22018988,7018988
Killing Them Softly,82,2012-11-30,15000000,14945541,39238443,24238443
Freddy Got Fingered,83,2001-04-20,15000000,14249005,14249005,-750995
One Day,84,2011-08-19,15000000,13843771,59168692,44168692
De-Lovely,85,2004-06-25,15000000,13337299,18524496,3524496
Whip It,86,2009-10-02,15000000,13077184,18889972,3889972
The Pirates Who Don't Do Anything: A VeggieTales Movie,87,2008-01-11,15000000,12981269,13248444,-1751556
U2 3D,88,2008-01-23,15000000,12898847,26170402,11170402
Highlander: Endgame,89,2000-09-01,15000000,12801190,12801190,-2198810
The Founder,90,2017-01-20,15000000,12786053,24403192,9403192
Idlewild,91,2006-08-25,15000000,12669914,12669914,-2330086
Confidence,92,2003-04-25,15000000,12212417,12212417,-2787583
Knockaround Guys,93,2002-10-11,15000000,11660180,12419700,-2580300
Here on Earth,98,2000-03-24,15000000,10494147,10845127,-4154873
Raise Your Voice,99,2004-10-08,15000000,10411980,14811980,-188020
Black Snake Moan,2,2007-03-02,15000000,9396870,10951153,-4048847
Dark Blue,3,2003-02-21,15000000,9237470,12262065,-2737935
A Mighty Heart,4,2007-06-22,15000000,9176787,19153568,4153568
Queen of Katwe,6,2016-09-23,15000000,8874389,10055481,-4944519
Whatever it Takes,7,2000-03-24,15000000,8735529,8735529,-6264471
Boat Trip,8,2003-03-21,15000000,8586376,14933713,-66287
The Importance of Being Earnest,9,2002-05-22,15000000,8378141,8378141,-6621859
Hoot,11,2006-05-05,15000000,8117637,8224998,-6775002
In Bruges,12,2008-02-08,15000000,7800825,34533783,19533783
Promised Land,13,2013-01-04,15000000,7597898,12394562,-2605438
Mulholland Drive,14,2001-10-08,15000000,7219578,20785973,5785973
Hotel Artemis,15,2018-06-08,15000000,6708137,12758799,-2241201
The Rocker,16,2008-08-20,15000000,6409528,8767338,-6232662
Post Grad,17,2009-08-21,15000000,6382178,6563402,-8436598
Whatever Works,18,2009-06-19,15000000,5306706,35106706,20106706
The In Crowd,19,2000-07-19,15000000,5217498,5217498,-9782502
Los tres entierros de Melquiades Estrada,20,2005-12-14,15000000,5027684,13454474,-1545526
Se jie,22,2007-09-28,15000000,4604982,65167430,50167430
"Kiss Kiss, Bang Bang",23,2005-10-21,15000000,4235837,16829464,1829464
Scouts Guide to the Zombie Apocalypse,25,2015-10-30,15000000,3703046,15554855,554855
Blood and Chocolate,26,2007-01-26,15000000,3526588,6551310,-8448690
You Will Meet a Tall Dark Stranger,27,2010-09-22,15000000,3247816,34247816,19247816
Rock the Kasbah,28,2015-10-23,15000000,3020665,3386153,-11613847
Never Let Me Go,29,2010-09-15,15000000,2434652,11173718,-3826282
The Disappointments Room,30,2016-09-09,15000000,2423467,3503761,-11496239
The Company,31,2003-12-25,15000000,2281585,3396508,-11603492
Transsiberian,32,2008-07-18,15000000,2203641,6379575,-8620425
The Comedian,35,2017-02-03,15000000,1658706,1658706,-13341294
Funny Games,36,2008-03-14,15000000,1294640,8200127,-6799873
Banlieue 13,37,2006-06-02,15000000,1200216,11599903,-3400097
Metropolis,39,2002-01-25,15000000,673414,1405032,-13594968
CÃ¬kÃ¨ NiÃ¨ YinniÃ¡ng,40,2015-10-16,15000000,632542,11279884,-3720116
The Reluctant Fundamentalist,42,2013-04-26,15000000,528731,528731,-14471269
The Return,43,2004-02-06,15000000,501752,5953886,-9046114
Buffalo Soldiers,44,2003-07-25,15000000,353743,353743,-14646257
Steal (Canadian Release),45,2003-04-25,15000000,220944,220944,-14779056
Centurion,46,2010-08-27,15000000,123570,7885048,-7114952
Ong-Bak 2,47,2009-10-23,15000000,102458,7583050,-7416950
Midnight Meat Train,49,2008-08-01,15000000,73548,1590246,-13409754
Winnie Mandela,50,2013-09-06,15000000,61847,61847,-14938153
The Son of No One,51,2011-11-04,15000000,30680,1148578,-13851422
All the Queen's Men,52,2002-10-25,15000000,22723,22723,-14977277
The Good Night,53,2007-10-05,15000000,22441,22441,-14977559
Khumba,54,2013-12-06,15000000,0,20898221,5898221
A Few Best Men,55,2015-05-05,15000000,0,17224539,2224539
AutÃ³mata,56,2014-10-10,15000000,0,6775458,-8224542
Chiamatemi Francesco - Il papa della gente,57,2015-12-31,15000000,0,3925769,-11074231
Bathory,58,2008-12-31,15000000,0,3436763,-11563237
San suk si gin,59,2010-02-05,15000000,0,2013340,-12986660
Dungeons & Dragons: Wrath of the Dragon God,60,2005-12-31,15000000,0,909822,-14090178
In Dubious Battle,61,2017-02-17,15000000,0,214182,-14785818
Broken Horses,62,2015-09-01,15000000,0,3471,-14996529
Pandaemonium,63,2001-06-29,15000000,0,0,-15000000
Magic Mike XXL,66,2015-07-01,14500000,66013057,123660597,109160597
Elle s'appelait Sarah,68,2011-07-22,14500000,7691700,25480031,10980031
Freedom,69,2015-06-05,14500000,0,872757,-13627243
Manderlay,71,2006-01-27,14200000,74205,543306,-13656694
Slumdog Millionaire,74,2008-11-12,14000000,141330703,384530440,370530440
Stomp the Yard,79,2007-01-12,14000000,61356221,75525718,61525718
My Bloody Valentine,80,2009-01-16,14000000,51545952,102836002,88836002
The Possession,81,2012-08-31,14000000,49130588,82925064,68925064
Tyler Perry's Good Deeds,86,2012-02-24,14000000,35025791,35579177,21579177
The Iron Lady,90,2012-01-13,14000000,29959436,115592104,101592104
Jonah: A VeggieTales Movie,92,2002-10-04,14000000,25571351,25608779,11608779
All About the Benjamins,93,2002-03-08,14000000,25482931,25873145,11873145
Our Family Wedding,95,2010-03-12,14000000,20255281,21410546,7410546
An American Haunting,97,2006-05-05,14000000,16298046,30443277,16443277
My Boss's Daughter,98,2003-08-22,14000000,15549702,15549702,1549702
A Perfect Getaway,99,2009-08-07,14000000,15515460,22815460,8815460
Jason X,4,2002-04-26,14000000,13121555,16951798,2951798
I Think I Love My Wife,6,2007-03-16,14000000,12559771,13205411,-794589
Hot Tub Time Machine 2,7,2015-02-20,14000000,12314651,12826644,-1173356
Bobby,8,2006-11-17,14000000,11242801,20597806,6597806
Head Over Heels,9,2001-02-02,14000000,10397365,10397365,-3602635
Fun Size,10,2012-10-26,14000000,9409538,11166615,-2833385
Le Scaphandre et le Papillon,12,2007-11-30,14000000,5990075,22754472,8754472
Little Children,13,2006-10-06,14000000,5463019,14121177,121177
Gossip,14,2000-04-21,14000000,5108820,12591270,-1408730
Suffragette,16,2015-10-23,14000000,4702420,34044909,20044909
Catch a Fire,17,2006-10-27,14000000,4299773,5782198,-8217802
Mr. Turner,18,2014-12-19,14000000,3958546,25187026,11187026
Soul Survivors,19,2001-09-07,14000000,3100650,4288246,-9711754
Easy Virtue,20,2009-05-22,14000000,2656784,20537741,6537741
Flipped,22,2010-08-06,14000000,1755212,4289993,-9710007
Les herbes folles,24,2010-06-25,14000000,403952,1903952,-12096048
Amen,25,2003-01-24,14000000,274299,274299,-13725701
The Lucky Ones,26,2008-09-26,14000000,266967,266967,-13733033
Margaret,27,2011-09-30,14000000,47185,623292,-13376708
Reign of Assassins,28,2016-11-01,14000000,0,11354230,-2645770
Stan Helsing: A Parody,29,2009-10-27,14000000,0,1553556,-12446444
Brokeback Mountain,30,2005-12-09,13900000,83043761,176980863,163080863
Ca$h,32,2008-12-31,13700000,0,11738256,-1961744
Far From Heaven,35,2002-11-08,13500000,15901849,29027914,15527914
Seven Psychopaths,36,2012-10-12,13500000,15024049,33035736,19535736
Quills,37,2000-11-22,13500000,7060876,11732088,-1767912
Der Untergang,39,2005-02-18,13500000,5501940,93631744,80131744
The Caveman's Valentine,40,2001-03-02,13500000,687081,892506,-12607494
The Last Godfather,41,2011-04-01,13400000,164247,164247,-13235753
Under the Skin,42,2014-04-04,13300000,2614251,7229933,-6070067
Mar adentro,43,2004-12-17,13300000,2086345,39686345,26386345
No Good Deed,44,2014-09-12,13200000,52543632,54323210,41123210
Black Swan,46,2010-12-03,13000000,106954678,331266710,318266710
Save the Last Dance,47,2001-01-12,13000000,91038276,122244329,109244329
Justin Bieber: Never Say Never,48,2011-02-11,13000000,73013910,99034125,86034125
The First Purge,49,2018-07-04,13000000,69488745,136617305,123617305
Miracles from Heaven,50,2016-03-16,13000000,61705123,73798736,60798736
Snow Day,51,2000-02-11,13000000,60008303,62452927,49452927
The Butterfly Effect,52,2004-01-23,13000000,57924679,95638592,82638592
The Shallows,54,2016-06-24,13000000,55121623,118763442,105763442
This Christmas,57,2007-11-21,13000000,49121934,49733545,36733545
About Last Night,58,2014-02-14,13000000,48637684,50445860,37445860
"Dude, Where's My Car?",59,2000-12-15,13000000,46729374,73180297,60180297
St. Vincent,61,2014-10-10,13000000,44137712,54837234,41837234
Earth to Echo,62,2014-07-02,13000000,38934842,42174545,29174545
The New Guy,64,2002-05-10,13000000,28972187,28972187,15972187
21 and Over,70,2013-03-01,13000000,25682380,42195766,29195766
The Mist,71,2007-11-21,13000000,25593755,57189408,44189408
Ex Machina,72,2015-04-10,13000000,25440971,38358392,25358392
Two Can Play That Game,74,2001-09-07,13000000,22235901,22391450,9391450
Eye in the Sky,75,2016-03-11,13000000,18704596,35402802,22402802
Admission,76,2013-03-22,13000000,18007317,18733666,5733666
The Perks of Being a Wallflower,77,2012-09-21,13000000,17742948,33069303,20069303
crazy/beautiful,78,2001-06-29,13000000,16929123,19929123,6929123
Room,80,2015-10-16,13000000,14677674,36262783,23262783
Woodlawn,81,2015-10-16,13000000,14394097,14403703,1403703
Letters from Iwo Jima,82,2006-12-20,13000000,13756082,67867998,54867998
MÃ¤n som hatar kvinnor,83,2009-05-29,13000000,12749992,109421911,96421911
The Astronaut Farmer,84,2007-02-23,13000000,11003643,11141213,-1858787
Bajrangi Bhaijaan,86,2015-07-17,13000000,8178001,121778347,108778347
Robinson Crusoe,88,2016-09-09,13000000,8005586,42446455,29446455
Bubble Boy,92,2001-08-24,13000000,5002310,5002310,-7997690
Birthday Girl,93,2002-02-01,13000000,4919896,8130727,-4869273
"Paris, je t'aime",94,2007-05-04,13000000,4857374,5175088,-7824912
Ben is Back,95,2018-12-07,13000000,3703182,9633111,-3366889
Resurrecting the Champ,96,2007-08-24,13000000,3172382,3260555,-9739445
Chloe,97,2010-03-26,13000000,3075255,11831131,-1168869
The Widow of St. Pierre,98,2001-03-02,13000000,3058380,3058380,-9941620
Youth,99,2015-12-04,13000000,2703296,24001573,11001573
Un ProphÃ¨te,1,2010-02-26,13000000,2087720,19910624,6910624
"I Love You, Phillip Morris",2,2010-12-03,13000000,2037459,23014027,10014027
The Vatican Tapes,3,2015-07-24,13000000,1784763,14929184,1929184
Find Me Guilty,4,2006-03-17,13000000,1173673,2898225,-10101775
Infamous,6,2006-10-13,13000000,1151330,2613717,-10386283
Attack the Block,7,2011-07-29,13000000,1024175,6459183,-6540817
Brothers,8,2015-08-14,13000000,656688,17856688,4856688
The Claim,9,2000-12-29,13000000,622023,1375635,-11624365
In The Land of Blood and Honey,10,2011-12-23,13000000,303877,509193,-12490807
The Killer Inside Me,11,2010-06-18,13000000,217277,3617277,-9382723
Womb,12,2012-03-30,13000000,0,0,-13000000
The Call,14,2013-03-15,12800000,51872378,69821476,57021476
Operation Chromite,15,2016-08-05,12700000,1022720,49196532,36496532
The Drop,16,2014-09-12,12600000,10724389,19054534,6454534
The Crocodile Hunter: Collision Course,17,2002-07-12,12500000,28436931,33436931,20936931
Machete,18,2010-09-03,12500000,26593646,46370970,33870970
Antwone Fisher,19,2002-12-19,12500000,21078145,23367586,10867586
The Emperor's Club,21,2002-11-22,12500000,14060950,16193713,3693713
Sorority Row,23,2009-09-11,12500000,11965282,26735797,14235797
The Boy in the Striped Pyjamas,25,2008-11-07,12500000,9046156,44083403,31583403
Conviction,28,2010-10-15,12500000,6797696,11826980,-673020
Lars and the Real Girl,29,2007-10-12,12500000,5956480,11277119,-1222881
Solitary Man,30,2010-05-21,12500000,4360548,4360548,-8139452
Dancer in the Dark,31,2000-09-22,12500000,4157491,45557491,33057491
Casino Jack,32,2010-12-17,12500000,2039869,2272186,-10227814
Tae Guik Gi: The Brotherhood of War,35,2004-09-03,12500000,1110186,69826708,57326708
The Perfect Game,36,2010-04-16,12500000,1089445,3931367,-8568633
The Paperboy,37,2012-10-05,12500000,677200,4027663,-8472337
Ernest et Celestine,38,2013-03-01,12500000,292562,9376444,-3123556
A Little Bit of Heaven,39,2012-05-04,12500000,10011,1100287,-11399713
The Fault in Our Stars,43,2014-06-06,12000000,124872350,307166834,295166834
Think Like a Man,45,2012-04-20,12000000,91547205,113373764,101373764
Heaven is for Real,46,2014-04-16,12000000,91386097,100916299,88916299
Barbershop,49,2002-09-13,12000000,75781642,77063461,65063461
Act of Valor,52,2012-02-24,12000000,70012847,82497035,70497035
Step Up,54,2006-08-11,12000000,65328121,110989157,98989157
Chronicle,55,2012-02-03,12000000,64575175,123681790,111681790
Project X,58,2012-03-02,12000000,54731865,103028188,91028188
"Three Billboards Outside Ebbing, Missouri",59,2017-11-10,12000000,54513740,160191915,148191915
Lion,60,2016-11-25,12000000,51739495,149570720,137570720
Overboard,61,2018-05-04,12000000,50316123,85369830,73369830
Harold & Kumar Escape from Guantanamo Bay,64,2008-04-25,12000000,38108728,43353117,31353117
Philomena,65,2013-11-22,12000000,37709979,98963392,86963392
Crossroads,67,2002-02-15,12000000,37188667,57000000,45000000
Paper Towns,68,2015-07-24,12000000,32000304,85450484,73450484
Quarantine,69,2008-10-10,12000000,31691811,41924774,29924774
One Hour Photo,70,2002-08-21,12000000,31597131,52223306,40223306
The Eye,71,2008-02-01,12000000,31418697,57577765,45577765
Johnson Family Vacation,72,2004-04-07,12000000,31203964,31286759,19286759
How High,73,2001-12-21,12000000,31155435,31222395,19222395
Crank,75,2006-09-01,12000000,27838408,43924923,31924923
Hell or High Water,77,2016-08-12,12000000,27007844,37584304,25584304
Frida,78,2002-10-25,12000000,25885000,56131239,44131239
Katy Perry: Part of Me,79,2012-07-05,12000000,25326071,32700439,20700439
Top Five,80,2014-12-12,12000000,25317379,26001741,14001741
Project Almanac,84,2015-01-30,12000000,22348241,32909437,20909437
Just Wright,85,2010-05-14,12000000,21540363,21867665,9867665
The Upside of Anger,89,2005-03-11,12000000,18761993,28915761,16915761
Aquamarine,90,2006-03-03,12000000,18597342,22978953,10978953
Nebraska,91,2013-11-15,12000000,17654912,24761360,12761360
My Baby's Daddy,92,2004-01-09,12000000,17321573,17322212,5322212
Max Keeble's Big Move,93,2001-10-05,12000000,17292381,17292381,5292381
Young Adult,94,2011-12-09,12000000,16311571,22750356,10750356
About Time,95,2013-11-01,12000000,15323921,89309178,77309178
If Beale Street Could Talk,96,2018-12-14,12000000,14915773,19859167,7859167
Wish Upon,97,2017-07-14,12000000,14301505,23477345,11477345
Rachel Getting Married,100,2008-10-03,12000000,12796861,17475475,5475475
Girl with a Pearl Earring,2,2003-12-12,12000000,11634362,43274797,31274797
Unforgettable,4,2017-04-21,12000000,11368012,16221211,4221211
House of Flying Daggers,5,2004-12-03,12000000,11050094,92863945,80863945
Sorority Boys,6,2002-03-22,12000000,10198766,12516222,516222
Marshall,7,2017-10-13,12000000,10051659,10116816,-1883184
Cadillac Records,8,2008-12-05,12000000,8195551,8942516,-3057484
Arbitrage,9,2012-09-14,12000000,7919574,35830713,23830713
Screwed,11,2000-05-12,12000000,6982680,6982680,-5017320
Running With Scissors,12,2006-10-20,12000000,6860000,8706701,-3293299
For Greater Glory: The True Story of Cristiada,14,2012-06-01,12000000,5669081,10026255,-1973745
For Your Consideration,15,2006-11-17,12000000,5549923,5549923,-6450077
From Justin to Kelly,17,2003-06-20,12000000,4922166,4922166,-7077834
In the Cut,20,2003-10-22,12000000,4717455,23693646,11693646
Charlie Bartlett,21,2008-02-22,12000000,3950294,5295909,-6704091
Two Lovers,22,2009-02-13,12000000,3149034,16349034,4349034
La grande bellezza,23,2013-11-15,12000000,2883879,29549145,17549145
Last Orders,24,2002-02-15,12000000,2326407,2326407,-9673593
Gwoemul,25,2007-03-09,12000000,2201923,92618117,80618117
The Dangerous Lives of Altar Boys,28,2002-06-14,12000000,1779284,1779284,-10220716
Stoker,29,2013-03-01,12000000,1703125,12034913,34913
Married Life,30,2008-03-07,12000000,1506998,2975188,-9024812
2046,31,2005-08-05,12000000,1442338,19287485,7287485
Kill the Irishman,32,2011-03-11,12000000,1188194,1188194,-10811806
Duma,33,2005-09-30,12000000,870067,994790,-11005210
Darling Companion,34,2012-04-20,12000000,793352,1200346,-10799654
Ondine,35,2010-06-04,12000000,550472,557545,-11442455
Brother,36,2001-07-20,12000000,450594,450594,-11549406
Welcome to Collinwood,37,2002-10-04,12000000,378650,4606284,-7393716
Life Before Her Eyes,38,2008-04-18,12000000,303439,7203439,-4796561
Trade,40,2007-09-28,12000000,214202,1513388,-10486612
Fateless,41,2006-01-06,12000000,196857,196857,-11803143
San qiang pai an jing qi,42,2010-09-03,12000000,190946,310946,-11689054
Company Man,44,2001-03-09,12000000,146028,622273,-11377727
Nanjing! Nanjing!,45,2009-11-07,12000000,122558,20122558,8122558
Trash,46,2015-10-09,12000000,17484,6553186,-5446814
5 Days of War,47,2011-08-19,12000000,17479,87793,-11912207
10 Days in a Madhouse,48,2015-11-11,12000000,14616,14616,-11985384
1612,49,2009-04-07,12000000,0,5400624,-6599376
San cheng ji,50,2015-12-31,12000000,0,1950194,-10049806
Tu Xia Chuan Qi,51,2011-12-31,12000000,0,1828400,-10171600
Triangle,52,2010-02-10,12000000,0,1594955,-10405045
Supesu Batorushippu Yamato,53,2013-10-19,12000000,0,0,-12000000
Drive Hard,54,2014-10-03,12000000,0,0,-12000000
Dancin' It's On,55,2015-10-30,12000000,0,0,-12000000
Home,56,2009-06-05,12000000,0,0,-12000000
The Dressmaker,57,2016-09-23,11900000,2022115,24041617,12141617
Carol,60,2015-11-20,11800000,12711491,42843521,31043521
Dirty Grandpa,62,2016-01-22,11500000,35593113,105078449,93578449
The Cry of the Owl,63,2009-11-27,11500000,0,0,-11500000
St. Trinianâs,64,2009-10-09,11400000,15000,29830239,18430239
The Fighter,68,2010-12-10,11000000,93617009,129262388,118262388
High School Musical 3: Senior Year,69,2008-10-24,11000000,90559416,274392880,263392880
Jackass: Number Two,71,2006-09-22,11000000,72778712,85278712,74278712
If I Stay,73,2014-08-22,11000000,50474843,78356170,67356170
Phone Booth,75,2003-04-04,11000000,46566212,97837138,86837138
A Walk to Remember,76,2002-01-25,11000000,41227069,46060861,35060861
Brooklyn,79,2015-11-04,11000000,38322743,62076141,51076141
The Secret Life of Bees,80,2008-10-17,11000000,37780486,39994347,28994347
Woman in Gold,81,2015-04-01,11000000,33307793,58586407,47586407
"I, Tonya",83,2017-12-08,11000000,30014534,53797409,42797409
Saw VI,84,2009-10-23,11000000,27693292,69752402,58752402
Corky Romano,85,2001-10-12,11000000,23978402,25116103,14116103
Quartet,90,2013-01-11,11000000,18388357,56178935,45178935
Out Cold,91,2001-11-21,11000000,13906394,14786394,3786394
The Ladies Man,92,2000-10-13,11000000,13592872,13719474,2719474
Tomcats,93,2001-03-30,11000000,13558739,13558739,2558739
Inside Llewyn Davis,94,2013-12-06,11000000,13248209,32943247,21943247
Frailty,95,2002-04-12,11000000,13110448,19947280,8947280
Kinsey,97,2004-11-12,11000000,10214647,17443529,6443529
Peeples,98,2013-05-10,11000000,9177065,9307166,-1692834
Sultan,100,2016-07-06,11000000,5599781,72989781,61989781
Slackers,1,2002-02-01,11000000,4814244,5942218,-5057782
The Gospel of John,2,2003-09-26,11000000,4068087,4234355,-6765645
Vera Drake,3,2004-10-10,11000000,3753806,13353855,2353855
The Guru,4,2003-01-31,11000000,3051221,24150550,13150550
Romance and Cigarettes,9,2007-09-07,11000000,551002,3231251,-7768749
Copying Beethoven,10,2006-11-10,11000000,355968,6586324,-4413676
Brighton Rock,11,2011-08-26,11000000,229653,229653,-10770347
Le prÃ©nom,12,2012-11-16,11000000,61611,25307405,14307405
La famille BÃ©lier,13,2015-05-08,11000000,0,82438670,71438670
LOL,14,2012-05-04,11000000,0,10431506,-568494
Misconduct,15,2016-02-05,11000000,0,2352511,-8647489
Saw V,17,2008-10-24,10800000,56746769,118209778,107409778
Les Intouchables,18,2012-05-25,10800000,13182281,484873045,474073045
Jindabyne,19,2007-04-27,10800000,399879,2862544,-7937456
Kabhi Alvida Naa Kehna,20,2006-08-11,10750000,3275443,32575443,21825443
Darkness,24,2004-12-25,10600000,22163442,34409206,23809206
The Last Days on Mars,25,2013-12-06,10600000,24084,261364,-10338636
In the Land of Women,28,2007-04-20,10500000,11052958,14140402,3640402
The Blue Butterfly,30,2004-02-20,10400000,1610194,1610194,-8789806
Le Fabuleux destin d'AmÃ©lie Poulain,31,2001-11-02,10350000,33201661,174201661,163851661
Housefull,34,2010-04-30,10100000,1183658,18726300,8626300
September Dawn,35,2007-08-24,10100000,1066555,1066555,-9033445
Halloween,36,2018-10-19,10000000,159342015,254900667,244900667
The Grudge,38,2004-10-22,10000000,110359362,187281115,177281115
Donât Breathe,39,2016-08-26,10000000,89217875,158973685,148973685
Saw III,41,2006-10-27,10000000,80238724,163876815,153876815
The Purge: Election Year,42,2016-07-01,10000000,79042440,118514727,108514727
Book Club,43,2018-05-18,10000000,68566296,91113683,81113683
Bring it On,44,2000-08-25,10000000,68353550,90453550,80453550
Insidious: The Last Key,45,2018-01-05,10000000,67745330,167885588,157885588
Saw IV,47,2007-10-26,10000000,63300095,135759694,125759694
Madea's Family Reunion,48,2006-02-24,10000000,63257940,63320521,53320521
White Noise,49,2005-01-07,10000000,56094360,92094360,82094360
Insidious Chapter 3,51,2015-06-05,10000000,52218558,120453155,110453155
Lady Bird,53,2017-11-03,10000000,48958273,78610769,68610769
Precious (Based on the Novel Push by Sapphire),54,2009-11-06,10000000,47566524,68722848,58722848
The Best Exotic Marigold Hotel,55,2012-05-04,10000000,46383639,134639780,124639780
Hereditary,56,2018-06-08,10000000,44069456,70133905,60133905
"Love, Simon",57,2018-03-16,10000000,40826341,65520633,55520633
Jigsaw,61,2017-10-27,10000000,38052832,102445196,92445196
Jeepers Creepers,62,2001-08-31,10000000,37904175,58939035,48939035
Recess: School's Out,65,2001-02-16,10000000,36696761,44451470,34451470
The Boy,68,2016-01-22,10000000,35819556,68220952,58220952
"Everything, Everything",70,2017-05-19,10000000,34121140,61603136,51603136
Devil,71,2010-09-17,10000000,33679655,63354114,53354114
Friday After Next,72,2002-11-22,10000000,33253609,33526835,23526835
The Second Best Exotic Marigold Hotel,73,2015-03-06,10000000,33078266,90384306,80384306
How to Be a Latin Lover,75,2017-04-28,10000000,32149404,62556228,52556228
Nick and Norah's Infinite Playlist,77,2008-10-03,10000000,31487293,33886017,23886017
Calendar Girls,78,2003-12-19,10000000,31011616,93074616,83074616
Slender Man,80,2018-08-10,10000000,30564825,51723644,41723644
The Banger Sisters,81,2002-09-20,10000000,30306281,38067218,28067218
Snatch,82,2000-12-08,10000000,30093107,83593107,73593107
Teen Titans Go! To The Movies,84,2018-07-27,10000000,29790236,51620593,41620593
When the Bough Breaks,85,2016-09-09,10000000,29747603,30768449,20768449
One Direction: This is Us,88,2013-08-30,10000000,28873374,68541786,58541786
Swimfan,89,2002-09-06,10000000,28564995,34084228,24084228
Employee of the Month,90,2006-10-06,10000000,28444855,38364855,28364855
Sinister 2,91,2015-08-21,10000000,27740955,54104225,44104225
The Forest,92,2016-01-08,10000000,26594261,40749230,30749230
The Fourth Kind,93,2009-11-06,10000000,26218170,49486874,39486874
Sparkle,96,2012-08-17,10000000,24397469,24660323,14660323
Kevin Hart: What Now?,97,2016-10-14,10000000,23591043,23591043,13591043
Mud,98,2013-04-26,10000000,21590086,31556959,21556959
Skyline,99,2010-11-12,10000000,21416355,68264973,58264973
The Disaster Artist,100,2017-12-01,10000000,21120616,28717667,18717667
Blair Witch,1,2016-09-16,10000000,20777061,38985577,28985577
Valentine,3,2001-02-02,10000000,20384136,20384136,10384136
A Prairie Home Companion,4,2006-06-09,10000000,20342852,26716191,16716191
Reno 911!: Miami,5,2007-02-23,10000000,20342161,21851362,11851362
Paranormal Activity: The Ghost Dimension,7,2015-10-23,10000000,18297124,77959374,67959374
Kit Kittredge: An American Girl,9,2008-06-20,10000000,17657973,17657973,7657973
Roll Bounce,11,2005-09-23,10000000,17380866,17433072,7433072
The Perfect Man,14,2005-06-17,10000000,16535005,19535005,9535005
Kung Pow: Enter the Fist,16,2002-01-25,10000000,16033556,17033556,7033556
The Birth of a Nation,17,2016-10-07,10000000,15861566,16891011,6891011
Wrong Turn,18,2003-05-30,10000000,15417771,28649556,18649556
"The Goods: Live Hard, Sell Hard",21,2009-08-14,10000000,15122676,15297318,5297318
My Week with Marilyn,22,2011-11-23,10000000,14597405,34240572,24240572
Big Eyes,23,2014-12-25,10000000,14482031,27317872,17317872
Broken Flowers,24,2005-08-05,10000000,13744960,40744960,30744960
Hey Arnold! The Movie,25,2002-06-28,10000000,13684949,13684949,3684949
The Matador,26,2005-12-30,10000000,12589255,17300838,7300838
The Gift,28,2000-12-19,10000000,12008642,44567606,34567606
End of the Spear,29,2006-01-20,10000000,11748661,11924041,1924041
Get Over It,30,2001-03-09,10000000,11560259,19860259,9860259
The Legend of Drunken Master,31,2000-10-20,10000000,11546543,11546543,1546543
Sleepover,38,2004-07-09,10000000,9408183,9408183,-591817
Movie 43,39,2013-01-25,10000000,8840453,31164747,21164747
Can You Ever Forgive Me?,40,2018-10-19,10000000,8803865,11752387,1752387
MacGruber,42,2010-05-21,10000000,8525600,8629895,-1370105
Dirty Pretty Things,43,2003-07-18,10000000,8112414,14156753,4156753
Bad Words,44,2014-03-14,10000000,7779614,7843145,-2156855
While We're Young,45,2015-03-27,10000000,7582065,17503828,7503828
Over Her Dead Body,46,2008-02-01,10000000,7570127,21596074,11596074
Bones,47,2001-10-24,10000000,7316658,8378853,-1621147
Seeking a Friend for the End of the World,48,2012-06-22,10000000,7078738,11766959,1766959
Turistas,49,2006-12-01,10000000,7027762,14321070,4321070
Shut In,50,2016-11-11,10000000,6900335,11360665,1360665
Cedar Rapids,51,2011-02-11,10000000,6861102,7862131,-2137869
The Collection,52,2012-11-30,10000000,6810754,8890094,-1109906
Teacher's Pet: The Movie,54,2004-01-16,10000000,6491969,6491969,-3508031
Deuces Wild,56,2002-05-03,10000000,6044618,6244618,-3755382
"Run, Fatboy, Run",57,2008-03-28,10000000,6003262,33512260,23512260
Danny Collins,59,2015-03-20,10000000,5637066,8465845,-1534155
Rescue Dawn,60,2007-07-04,10000000,5490423,7037886,-2962114
Black and White,61,2000-04-05,10000000,5241315,5241315,-4758685
Io sono lâamore,62,2010-06-18,10000000,5005465,15121528,5121528
On the Line,63,2001-10-26,10000000,4365455,4690802,-5309198
Gotti,64,2018-06-15,10000000,4286367,6089100,-3910900
"Jeff, Who Lives at Home",65,2012-03-16,10000000,4269426,4708127,-5291873
Denial,66,2016-09-30,10000000,4073448,9263940,-736060
The Man Who Knew Infinity,67,2016-04-29,10000000,3877922,12382122,2382122
Max Steel,68,2016-10-14,10000000,3818664,4563080,-5436920
Everybody Wants Some,69,2016-03-30,10000000,3400278,5437126,-4562874
Atlas Shrugged: Part II,71,2012-10-12,10000000,3336053,3336053,-6663947
Rosewater,74,2014-11-14,10000000,3128941,3185717,-6814283
The House of Mirth,75,2000-12-22,10000000,3041803,5149131,-4850869
Peaceful Warrior,77,2006-06-02,10000000,2893666,3260179,-6739821
Bucky Larson: Born to Be a Star,78,2011-09-09,10000000,2529395,2529395,-7470605
Bamboozled,79,2000-10-06,10000000,2185266,2373937,-7626063
The Iceman,81,2013-05-03,10000000,1930282,3623609,-6376391
Testament of Youth,82,2015-06-05,10000000,1822250,6646669,-3353331
Free Fire,83,2017-04-21,10000000,1799322,3793739,-6206261
A Better Life,84,2011-06-24,10000000,1759252,1884251,-8115749
Spider,85,2003-02-28,10000000,1641788,1641788,-8358212
Gun Shy,86,2000-02-04,10000000,1638202,1638202,-8361798
Nicholas Nickleby,87,2002-12-27,10000000,1562800,1562800,-8437200
The Joneses,88,2010-04-16,10000000,1475746,3541565,-6458435
Krrish,89,2006-06-23,10000000,1430721,32430721,22430721
Killer Joe,90,2012-07-27,10000000,1291645,4659110,-5340890
Churchill,91,2017-06-02,10000000,1279681,7582196,-2417804
Cecil B. Demented,92,2000-08-11,10000000,1276984,1953882,-8046118
50 to 1,93,2014-03-21,10000000,1069454,1069454,-8930546
Owning Mahowny,94,2003-05-02,10000000,1011054,1011054,-8988946
The Ten Commandments,95,2007-10-19,10000000,952820,1051907,-8948093
The Brothers Solomon,96,2007-09-07,10000000,900926,900926,-9099074
My Blueberry Nights,97,2008-04-04,10000000,866778,22198996,12198996
Coriolanus,99,2012-01-20,10000000,749641,2179623,-7820377
Parkland,100,2013-10-04,10000000,641439,1616353,-8383647
Swept Away,1,2002-10-11,10000000,598645,598645,-9401355
"War, Inc.",2,2008-05-23,10000000,580862,1299855,-8700145
Shaolin Soccer,3,2004-04-02,10000000,488872,42776032,32776032
The Brown Bunny,4,2004-08-27,10000000,366301,630427,-9369573
King of California,5,2007-09-14,10000000,268461,1165102,-8834898
Imaginary Heroes,8,2004-12-17,10000000,228524,290875,-9709125
High Heels and Low Lifes,9,2001-10-26,10000000,226792,226792,-9773208
World's Greatest Dad,10,2009-08-21,10000000,221805,295750,-9704250
"Cinco de Mayo, La Batalla",11,2013-05-03,10000000,173472,173472,-9826528
Welcome to the Rileys,12,2010-10-29,10000000,152857,355919,-9644081
Kicks,13,2016-09-09,10000000,150191,150191,-9849809
Free Style,14,2009-10-09,10000000,141108,721108,-9278892
High School,15,2012-06-01,10000000,139034,248133,-9751867
Severance,16,2007-05-18,10000000,137221,5950002,-4049998
Edmond,17,2006-07-14,10000000,131719,241719,-9758281
Joheunnom nabbeunnom isanghannom,18,2010-04-23,10000000,128486,42226657,32226657
Blood Done Sign My Name,20,2010-02-19,10000000,109383,109383,-9890617
The Good Guy,21,2010-02-19,10000000,100688,106460,-9893540
Motherhood,22,2009-10-23,10000000,93388,723388,-9276612
Eulogy,23,2004-10-15,10000000,70527,70527,-9929473
Elsa & Fred,24,2014-11-07,10000000,67657,197901,-9802099
The Open Road,26,2009-08-28,10000000,19716,19716,-9980284
Strangerland,27,2015-07-10,10000000,17472,161097,-9838903
Hross i oss,28,2015-03-13,10000000,11894,11894,-9988106
Janky Promoters,29,2009-10-16,10000000,9069,9069,-9990931
Blonde Ambition,30,2007-12-21,10000000,6422,1537479,-8462521
The Oxford Murders,31,2010-08-06,10000000,4803,17704131,7704131
Barbecue,32,2014-12-26,10000000,388,247565,-9752435
The Reef,33,2010-12-31,10000000,0,15037867,5037867
White Noise 2: The Light,34,2008-01-08,10000000,0,8243567,-1756433
American Heist,35,2015-07-21,10000000,0,2341218,-7658782
It's a Wonderful Afterlife,36,2010-10-08,10000000,0,1642939,-8357061
You Got Served: Beat The World,37,2011-06-21,10000000,0,1230542,-8769458
Fifty Dead Men Walking,38,2009-08-21,10000000,0,997921,-9002079
Plastic,39,2014-09-26,10000000,0,575371,-9424629
Jungle Shuffle,40,2015-03-10,10000000,0,360898,-9639102
Adam Resurrected,41,2009-09-22,10000000,0,90909,-9909091
The Devil's Tomb,42,2009-05-26,10000000,0,0,-10000000
Good Intentions,43,2009-12-31,10000000,0,0,-10000000
Partition,44,2007-02-02,10000000,0,0,-10000000
Detention,45,2012-04-13,10000000,0,0,-10000000
Nurse 3D,46,2014-02-07,10000000,0,0,-10000000
Into the Grizzly Maze,47,2015-05-19,10000000,0,0,-10000000
Friend Request,48,2017-09-22,9900000,3759078,11310835,1410835
Gunless,49,2010-04-30,9900000,458054,458054,-9441946
Adventureland,50,2009-04-03,9800000,16044025,17553055,7753055
Amour,51,2012-12-19,9700000,6738954,36787044,27087044
The Lost City,52,2006-04-28,9600000,2484186,5256839,-4343161
Next Friday,53,2000-01-12,9500000,57176582,59675307,50175307
Dangal,56,2016-12-21,9500000,12391761,294654618,285154618
The Runaways,57,2010-03-19,9500000,3573673,5278632,-4221368
Gentlemen Broncos,58,2009-10-30,9500000,115155,119955,-9380045
Re-Kill,59,2013-12-31,9500000,0,0,-9500000
Volver,61,2006-11-03,9400000,12899867,87226613,77826613
Melancholia,62,2011-11-11,9400000,3030848,21817298,12417298
Jab Tak Hai Jaan,64,2012-11-13,9200000,3047539,5806666,-3393334
Kites,66,2010-05-21,9200000,1685269,17155193,7955193
Red Dog,67,2011-12-31,9100000,0,20927794,11827794
Mine Vaganti,68,2010-12-31,9100000,0,18872126,9772126
The Texas Chainsaw Massacre,69,2003-10-17,9000000,80571655,107967319,98967319
The Purge: Anarchy,71,2014-07-18,9000000,71562550,111534881,102534881
The Strangers,73,2008-05-30,9000000,52597610,83051676,74051676
Ouija: Origin of Evil,75,2016-10-21,9000000,35144505,81831866,72831866
Sicko,79,2007-06-22,9000000,24538513,36535837,27535837
Black or White,80,2015-01-30,9000000,21571189,21971021,12971021
Down to You,81,2000-01-21,9000000,20035310,20035310,11035310
Harold & Kumar Go to White Castle,82,2004-07-30,9000000,18225165,18225165,9225165
The Contender,83,2000-10-13,9000000,17804273,17804273,8804273
Boiler Room,84,2000-02-18,9000000,16963963,28773637,19773637
Black Christmas,85,2006-12-05,9000000,16235738,16235738,7235738
The Edge of Seventeen,86,2016-11-18,9000000,14431633,19096003,10096003
Jackie,87,2016-12-02,9000000,13960394,36588512,27588512
Breakin' All the Rules,89,2004-05-14,9000000,12232382,12512317,3512317
Glee: The 3D Concert Movie,90,2011-08-12,9000000,11862398,17462398,8462398
Loving,92,2016-11-04,9000000,7710234,12898064,3898064
The Savages,93,2007-11-28,9000000,6623082,10642023,1642023
Chasing Papi,94,2003-04-16,9000000,6126237,12657377,3657377
The Way of the Gun,95,2000-09-08,9000000,6047856,13061935,4061935
Hamlet 2,97,2008-08-22,9000000,4886216,4934104,-4065896
Igby Goes Down,98,2002-09-13,9000000,4777465,4777465,-4222535
The Ultimate Gift,100,2007-03-09,9000000,3438735,3438735,-5561265
Beautiful,1,2000-09-29,9000000,3134509,3134509,-5865491
Gracie,2,2007-06-01,9000000,2956339,3922043,-5077957
The Sapphires,3,2013-03-22,9000000,2450867,20395040,11395040
Greater,4,2016-08-26,9000000,2000093,2000093,-6999907
Destroyer,5,2018-12-25,9000000,1533324,3681096,-5318904
Trust the Man,6,2006-08-18,9000000,1530535,2548378,-6451622
Undiscovered,7,2005-08-26,9000000,1069318,1069318,-7930682
Princess Kaiulani,9,2010-05-14,9000000,883887,883887,-8116113
The Legend of Suriyothai,10,2003-06-20,9000000,454255,454255,-8545745
Dheepan,12,2016-05-06,9000000,248795,7704357,-1295643
La fille du RER,13,2010-01-22,9000000,208163,208163,-8791837
All or Nothing,14,2002-10-25,9000000,184255,184255,-8815745
Red Riding: The Year of Our Lord 1974,15,2010-02-05,9000000,148826,148826,-8851174
Flammen og Citronen,16,2009-07-31,9000000,148089,1635241,-7364759
Leaves of Grass,17,2010-04-02,9000000,70066,85527,-8914473
Opal Dream,18,2006-11-22,9000000,14443,14443,-8985557
Skin Trade,19,2015-05-08,9000000,1242,1242,-8998758
Beneath Hill 60,20,2014-06-17,9000000,0,3440939,-5559061
Veronika Decides to Die,21,2015-01-20,9000000,0,2243,-8997757
A Haunting in Connecticut 2: The Ghosts of Georgia,23,2013-02-01,9000000,0,0,-9000000
Polisse,24,2012-05-18,8900000,176988,22744132,13844132
Heist,25,2015-11-13,8900000,50136,3324131,-5575869
Ultramarines,26,2011-02-26,8900000,0,0,-8900000
The I Inside,28,2004-12-31,8800000,0,0,-8800000
Awake,29,2007-11-30,8600000,14373825,32968648,24368648
Manchester by the Sea,30,2016-11-18,8500000,47695371,77733867,69233867
Crazy Heart,31,2009-12-16,8500000,39471742,47417251,38917251
Star Wars: The Clone Wars,32,2008-08-15,8500000,35161554,68695443,60195443
The DUFF,33,2015-02-20,8500000,34030343,43528634,35028634
Nightcrawler,34,2014-10-31,8500000,32381218,50334418,41834418
Baggage Claim,38,2013-09-27,8500000,21569509,22885836,14385836
Middle School: The Worst Years of My Life,39,2016-10-07,8500000,20007149,23311293,14811293
The Namesake,42,2007-03-09,8500000,13610521,20288774,11788774
All is Lost,43,2013-10-18,8500000,6263670,10386814,1886814
Club Dread,44,2004-02-27,8500000,5001655,7573551,-926449
Bright Star,45,2009-09-17,8500000,4444637,17220091,8720091
Glitter,46,2001-09-21,8500000,4273372,4273372,-4226628
The Rover,47,2014-06-13,8500000,1109199,3180252,-5319748
Silmido,48,2004-04-23,8500000,298347,30298347,21798347
Repo! The Genetic Opera,49,2008-11-07,8500000,140244,198883,-8301117
Posledniy bogatyr,50,2017-12-31,8500000,0,30700192,22200192
A.C.O.R.N.S.: Operation Crackdown,51,2016-11-01,8500000,0,1353287,-7146713
My Name is Khan,52,2010-02-12,8470000,4046336,42355526,33885526
Namastey London,53,2007-03-23,8400000,1207007,6831069,-1568931
Yeh Jawaani Hai Deewani,54,2013-05-31,8300000,3827466,50827466,42527466
The Wind That Shakes the Barley,56,2007-03-16,8300000,1829142,25670174,17370174
The City of Your Final Destination,57,2010-04-16,8300000,493296,1353296,-6946704
Kurtlar vadisi - Irak,58,2006-11-24,8300000,0,24906717,16606717
Little Miss Sunshine,66,2006-07-26,8000000,59891098,100642353,92642353
Easy A,67,2010-09-17,8000000,58401464,76200721,68200721
28 Days Laterâ¦,69,2003-06-27,8000000,45064915,82955633,74955633
You Got Served,71,2004-01-30,8000000,40066497,50811858,42811858
50/50,73,2011-09-30,8000000,35016118,41334735,33334735
A Walk in the Woods,75,2015-09-02,8000000,29499394,37119358,29119358
Brown Sugar,76,2002-10-11,8000000,27362712,28315272,20315272
That Awkward Moment,78,2014-01-31,8000000,26068955,53068955,45068955
Shutter,79,2008-03-21,8000000,25928550,47782426,39782426
Akeelah and the Bee,85,2006-04-28,8000000,18848430,18959424,10959424
Enough Said,88,2013-09-18,8000000,17550872,25621449,17621449
New in Town,90,2009-01-30,8000000,16734283,29937909,21937909
Begin Again,91,2014-06-27,8000000,16170632,68838736,60838736
American Psycho,92,2000-04-14,8000000,15070285,34270285,26270285
See No Evil,93,2006-05-19,8000000,15032800,18828036,10828036
The Good Girl,94,2002-08-07,8000000,14018296,16585503,8585503
"Bon Cop, Bad Cop",95,2006-08-04,8000000,12671300,12740705,4740705
The Boondock Saints 2: All Saints Day,96,2009-10-30,8000000,10273187,10629320,2629320
Prom,97,2011-04-29,8000000,10130219,10763183,2763183
Shadow of the Vampire,99,2000-12-29,8000000,8279017,8279017,279017
Me and Earl and the Dying Girl,100,2015-06-12,8000000,6758416,9266180,1266180
It's Kind of a Funny Story,1,2010-10-08,8000000,6363628,6632950,-1367050
Woman on Top,3,2000-09-22,8000000,5018450,10192613,2192613
Held Up,4,2000-05-12,8000000,4714090,4714090,-3285910
Morgan,5,2016-09-02,8000000,3915251,7298786,-701214
Anomalisa,6,2015-12-30,8000000,3759286,5706168,-2293832
CachÃ©,7,2005-12-23,8000000,3647381,19891331,11891331
Another Year,8,2010-12-29,8000000,3205706,20005613,12005613
8 femmes,9,2002-09-20,8000000,3076425,42376425,34376425
Le passÃ©,12,2013-12-20,8000000,1335672,15752575,7752575
Lean on Pete,13,2018-04-06,8000000,1163056,2455027,-5544973
Made in Dagenham,14,2010-11-19,8000000,1095369,15644196,7644196
And When Did You Last See Your Father?,15,2008-06-06,8000000,1071240,2476491,-5523509
The Secret of Kells,17,2010-03-05,8000000,690290,3582797,-4417203
Down in the Valley,20,2006-05-05,8000000,568932,973443,-7026557
Brooklyn Rules,21,2007-05-11,8000000,458232,458232,-7541768
The Singing Detective,22,2003-10-24,8000000,336456,524747,-7475253
Fido,23,2007-06-15,8000000,298110,456814,-7543186
London Fields,24,2018-10-26,8000000,252676,433732,-7566268
Restless,25,2011-09-16,8000000,163753,2772511,-5227489
The Wendell Baker Story,27,2007-05-18,8000000,127188,127188,-7872812
Wild Target,28,2010-10-29,8000000,109338,5314194,-2685806
Pathology,29,2008-04-18,8000000,109045,3270974,-4729026
Wuthering Heights,30,2012-10-05,8000000,100915,2721534,-5278466
A Street Cat Named Bob,31,2016-11-18,8000000,82703,17382693,9382693
10th & Wolf,32,2006-08-18,8000000,54702,143782,-7856218
Aloft,33,2015-05-22,8000000,53086,237688,-7762312
Fireflies in the Garden,34,2011-10-14,8000000,36884,3587191,-4412809
Dear Wendy,35,2005-09-23,8000000,23106,446438,-7553562
Akira,36,2001-04-27,8000000,19585,19585,-7980415
Welcome to Dongmakgol,37,2005-12-31,8000000,0,48000000,40000000
Feichang Xingyun,38,2013-09-20,8000000,0,21970000,13970000
"Don Gato, el inicio de la pandilla",39,2017-09-29,8000000,0,4604656,-3395344
The Death and Life of Bobby Z,40,2007-09-04,8000000,0,414617,-7585383
Backstabbing For Beginners,41,2018-04-24,8000000,0,343773,-7656227
Swelter,42,2014-08-12,8000000,0,44197,-7955803
Maurice Richard,43,2007-11-30,8000000,0,0,-8000000
Green Street Hooligans: Underground,44,2015-02-24,8000000,0,0,-8000000
Christmas in Beverly Hills,45,2009-12-31,8000000,0,0,-8000000
Henry Joseph Church,46,2015-12-31,8000000,0,0,-8000000
Code of Honor,47,2016-05-06,8000000,0,0,-8000000
Imagine Me & You,49,2006-01-27,7900000,672243,3129471,-4770529
Swimming Pool,50,2003-07-04,7800000,10130108,24021282,16221282
Loin des hommes,52,2015-04-14,7700000,5336,1080428,-6619572
(500) Days of Summer,55,2009-07-17,7500000,32425665,34439060,26939060
Thank You For Smoking,57,2006-03-17,7500000,24793509,40016662,32516662
Hostel: Part II,58,2007-06-08,7500000,17544812,33606409,26106409
An Education,59,2009-10-09,7500000,12574914,29652736,22152736
Extract,60,2009-09-04,7500000,10823158,10849158,3349158
Narc,61,2002-12-20,7500000,10465659,11843260,4343260
Shopgirl,62,2005-10-21,7500000,10284523,11758418,4258418
Men with Brooms,64,2002-03-08,7500000,4239767,4239767,-3260233
Witless Protection,65,2008-02-22,7500000,4151836,4151836,-3348164
The Work and the Glory,66,2004-11-24,7500000,3347647,3347647,-4152353
Albert Nobbs,67,2011-12-21,7500000,3014696,8539003,1039003
The Neon Demon,68,2016-06-24,7500000,1333124,3559803,-3940197
Masked and Anonymous,69,2003-07-24,7500000,533344,555335,-6944665
Borg vs McEnroe,70,2018-04-13,7500000,231346,3257922,-4242078
Betty Fisher et autres histoires,71,2002-09-13,7500000,206400,206400,-7293600
Code 46,72,2004-08-06,7500000,197148,1788324,-5711676
The Hole,73,2001-12-31,7500000,0,10834406,3334406
Black November,74,2015-01-09,7500000,0,32572,-7467428
Outside Bet,75,2015-02-24,7500000,0,13524,-7486476
Pound of Flesh,76,2015-05-15,7500000,0,0,-7500000
The Bye Bye Man,77,2017-01-13,7400000,22395806,31187727,23787727
Ta Ra Rum Pum,78,2007-04-27,7400000,872643,9443864,2043864
Crash,79,2005-05-06,7303082,55334418,101173038,93869956
Persepolis,80,2007-12-25,7300000,4443403,25397187,18097187
Harry Brown,81,2010-04-30,7300000,1818681,12023606,4723606
Die Welle,82,2011-05-27,7250000,0,35122948,27872948
3,85,2011-09-16,7200000,59774,295492,-6904508
Juno,86,2007-12-05,7000000,143495265,231450102,224450102
Magic Mike,88,2012-06-29,7000000,113721571,170549753,163549753
I Can Only Imagine,90,2018-03-16,7000000,83482352,85604221,78604221
Jumping the Broom,93,2011-05-06,7000000,37295394,38158601,31158601
My Dog Skip,95,2000-01-12,7000000,34099640,35795319,28795319
Darkness Falls,96,2003-01-24,7000000,32539681,47289758,40289758
"Definitely, Maybe",97,2008-02-14,7000000,32241649,55617866,48617866
"Good Night, and Good Luck",98,2005-10-07,7000000,31501218,56586901,49586901
Capote,99,2005-09-30,7000000,28750530,49924079,42924079
The Descent,1,2006-08-04,7000000,26024456,57051053,50051053
Gifted,4,2017-04-07,7000000,24801212,36964656,29964656
Kingdom Come,6,2001-04-11,7000000,23247539,23393939,16393939
Michael Jordan to the MAX,10,2000-05-05,7000000,18642318,18642318,11642318
Dope,11,2015-06-19,7000000,17506470,18190831,11190831
The Devil's Rejects,12,2005-07-22,7000000,17044981,20940428,13940428
Devil's Due,14,2014-01-17,7000000,15821461,36146087,29146087
Beyond the Lights,16,2014-11-14,7000000,14618727,14618727,7618727
"House of 1,000 Corpses",19,2003-04-11,7000000,12634962,17005466,10005466
House of the Dead,21,2003-10-10,7000000,10199354,13860078,6860078
A Serious Man,22,2009-10-02,7000000,9228788,30360570,23360570
Get Low,23,2010-07-30,7000000,9176933,10828305,3828305
A Single Man,24,2009-12-11,7000000,9176000,28142379,21142379
Cyrus,27,2010-06-18,7000000,7468936,10062896,3062896
Bride & Prejudice,29,2005-02-11,7000000,6601079,25269040,18269040
Rabbit-Proof Fence,30,2002-11-29,7000000,6199600,16866928,9866928
Who's Your Caddy?,31,2007-07-27,7000000,5694308,5694308,-1305692
The Other Side of Heaven,34,2001-12-14,7000000,4720371,4720371,-2279629
Veer-Zaara,37,2004-11-12,7000000,2938532,7017859,17859
Redbelt,38,2008-05-02,7000000,2344847,2667084,-4332916
Auto Focus,40,2002-10-18,7000000,2062066,2703821,-4296179
The Mighty Macs,41,2011-10-21,7000000,1891936,1891936,-5108064
Somewhere,42,2010-12-22,7000000,1785645,17023121,10023121
We Need to Talk About Kevin,43,2012-01-13,7000000,1738692,10765283,3765283
Factory Girl,44,2007-02-02,7000000,1661464,1661464,-5338536
The Christmas Candle,45,2013-11-15,7000000,1632000,1933829,-5066171
I Hope They Serve Beer in Hell,46,2009-09-25,7000000,1429299,1429453,-5570547
Mother and Child,48,2010-05-07,7000000,1110509,6537179,-462821
Freeheld,51,2015-10-02,7000000,546201,1732228,-5267772
Dom Hemingway,52,2014-04-02,7000000,523511,1857458,-5142542
The Extra Man,53,2010-07-30,7000000,453377,492108,-6507892
Hesher,54,2011-05-13,7000000,382946,382946,-6617054
Gerry,56,2003-02-14,7000000,254683,719699,-6280301
Wah-Wah,57,2006-05-12,7000000,234750,463039,-6536961
The Heart of Me,58,2003-06-13,7000000,196067,196067,-6803933
Ca$h,59,2010-03-26,7000000,46488,46488,-6953512
Trudno byt bogom,60,2015-01-30,7000000,31443,41038,-6958962
The Boondock Saints,61,2000-01-21,7000000,30471,411874,-6588126
Snezhnaya koroleva,62,2014-01-28,7000000,0,15193977,8193977
Oddball,63,2016-12-06,7000000,0,10237229,3237229
Z Storm,64,2015-08-18,7000000,0,2053330,-4946670
Geroy,65,2015-12-31,7000000,0,1545121,-5454879
Twixt,66,2013-07-23,7000000,0,1268346,-5731654
Criminal Activities,67,2015-11-20,7000000,0,386744,-6613256
High School Musical 2,68,2007-12-11,7000000,0,0,-7000000
The Kings of Appletown,69,2008-12-12,7000000,0,0,-7000000
Stargate - The Ark of Truth,70,2008-03-11,7000000,0,0,-7000000
Alpha & Omega: The Legend of the Saw Tooth Cave,71,2015-09-01,7000000,0,0,-7000000
House at the End of the Street,73,2012-09-21,6900000,31611916,44103982,37203982
Two Lovers and a Bear,75,2017-01-31,6840000,0,22273,-6817727
Incendies,76,2010-09-17,6800000,6857096,16038343,9238343
AimÃ©e & Jaguar,77,2000-08-11,6800000,927107,927107,-5872893
The Chumscrubber,78,2005-08-05,6800000,49526,49526,-6750474
Shade,79,2004-04-09,6800000,25032,9533964,2733964
Bran Nue Dae,80,2010-09-10,6750000,113568,6812530,62530
"Remember Me, My Love",81,2004-09-03,6700000,223878,223878,-6476122
Perrierâs Bounty,82,2010-05-21,6600000,828,828,-6599172
Tropa de Elite,83,2008-09-19,6537890,8744,14319195,7781305
Annabelle,84,2014-10-03,6500000,84273813,256862920,250362920
Hannah Montana/Miley Cyrus: Best of Both Worlds Concert Tour,85,2008-02-01,6500000,65281781,70712099,64212099
Friends with Money,92,2006-04-07,6500000,13368437,18110152,11610152
Same Kind of Different as Me,95,2017-10-20,6500000,6423605,6423605,-76395
Nowhere in Africa,96,2003-03-07,6500000,6173485,6173485,-326515
Shame,97,2011-12-02,6500000,4002293,20412841,13912841
Layer Cake,98,2005-05-13,6500000,2339957,11745931,5245931
The East,99,2013-05-31,6500000,2274649,3027956,-3472044
The Work and the Glory: American Zion,100,2005-10-21,6500000,2025032,2025032,-4474968
The Messenger,1,2009-11-13,6500000,1109660,1744952,-4755048
A Home at the End of the World,2,2004-07-23,6500000,1029017,1033810,-5466190
Aberdeen,3,2001-08-17,6500000,64148,64148,-6435852
Tracker,4,2011-12-31,6500000,0,3149,-6496851
"Good Bye, Lenin!",6,2004-02-27,6400000,4063859,79384539,72984539
Control,7,2007-10-10,6400000,871577,8902141,2502141
The Damned United,8,2009-10-09,6400000,449865,4199874,-2200126
Die FÃ¤lscher,9,2008-02-22,6250000,5488570,20199663,13949663
Gomorra,11,2009-02-13,6200000,1579146,37339594,31139594
Fahrenheit 9/11,15,2004-06-23,6000000,119114517,221148959,215148959
Breaking In,19,2018-05-11,6000000,46840590,51411620,45411620
The Brothers,23,2001-03-23,6000000,27457409,27958191,21958191
The Wrestler,24,2008-12-17,6000000,26238243,46634275,40634275
National Lampoonâs Van Wilder,30,2002-04-05,6000000,21305259,39241323,33241323
Best in Show,32,2000-09-27,6000000,18621249,20695413,14695413
The Last King of Scotland,34,2006-09-27,6000000,17606684,49155371,43155371
A Mighty Wind,35,2003-04-16,6000000,17583468,18504539,12504539
The Possession of Hannah Grace,37,2018-11-30,6000000,14836174,42785387,36785387
Daddy Day Camp,39,2007-08-08,6000000,13235267,18209872,12209872
The Words,46,2012-09-07,6000000,11494838,16369708,10369708
The Lady in the Van,47,2016-01-15,6000000,10021175,42320503,36320503
Bernie,48,2012-04-27,6000000,9204489,10106975,4106975
Pollock,49,2000-12-15,6000000,8596914,10557291,4557291
Dolphins and Whales Tribes of the Ocean 3D,50,2008-02-15,6000000,7714996,17252287,11252287
City Island,52,2010-03-19,6000000,6671283,8173486,2173486
Casa de mi Padre,53,2012-03-16,6000000,5909483,8446952,2446952
The Guard,54,2011-07-29,6000000,5359774,21197454,15197454
The Virgin Suicides,55,2000-04-21,6000000,4859475,10619770,4619770
College,56,2008-08-29,6000000,4694491,6176114,176114
La science des rÃªves,57,2006-09-22,6000000,4670644,15137932,9137932
Miss March,59,2009-03-13,6000000,4543320,4713059,-1286941
Wish I Was Here,61,2014-07-18,6000000,3591299,6591365,591365
Venus,62,2006-12-21,6000000,3347411,7818479,1818479
Veronica Mars,63,2014-03-14,6000000,3322127,3485383,-2514617
Hedwig and the Angry Inch,65,2001-07-20,6000000,3067312,3740030,-2259970
Shattered Glass,66,2003-10-31,6000000,2207975,3456602,-2543398
The Wackness,67,2008-07-03,6000000,2077046,3330012,-2669988
Novocaine,68,2001-11-16,6000000,2025238,2522928,-3477072
Polytechnique,69,2009-02-06,6000000,1418304,1418304,-4581696
Snow Flower and the Secret Fan,70,2011-07-15,6000000,1348205,11348205,5348205
Mandy,71,2018-09-14,6000000,1214525,1427656,-4572344
The Business of Strangers,72,2001-12-07,6000000,1030920,1290920,-4709080
JÃ»san-nin no shikaku,73,2011-04-29,6000000,802778,18727440,12727440
The 5th Quarter,76,2011-03-25,6000000,408159,408159,-5591841
Morvern Callar,78,2002-12-20,6000000,267194,267194,-5732806
The Flower of Evil,79,2003-10-10,6000000,181798,181798,-5818202
Akmareul Boatda,80,2011-03-04,6000000,129210,13168809,7168809
Come Early Morning,81,2006-11-10,6000000,119452,119452,-5880548
The Greatest,82,2010-04-02,6000000,115862,117796,-5882204
Deadfall,83,2012-12-07,6000000,66351,1673635,-4326365
Julia,84,2009-05-08,6000000,65108,1365108,-4634892
Lucky Break,85,2002-04-05,6000000,54606,4316497,-1683503
"Surfer, Dude",86,2008-09-05,6000000,36497,36497,-5963503
Song One,87,2015-01-23,6000000,32251,437089,-5562911
Lake of Fire,88,2007-10-03,6000000,25317,26007,-5973993
Don McKay,89,2010-04-02,6000000,13722,13722,-5986278
11:14,90,2005-08-12,6000000,0,0,-6000000
Icarus,91,2010-02-09,6000000,0,0,-6000000
A Shine of Rainbows,93,2011-03-15,6000000,0,0,-6000000
Freaky Deaky,94,2011-12-31,6000000,0,0,-6000000
The Hit List,95,2011-05-10,6000000,0,0,-6000000
L\'auberge espagnole,98,2003-03-21,5900000,3895664,3895664,-2004336
Winter in Wartime,1,2011-03-18,5800000,542860,9662214,3862214
Foolproof,2,2003-10-03,5800000,230312,421021,-5378979
Trade of Innocents,3,2012-10-05,5800000,15091,15091,-5784909
Tom yum goong,4,2006-09-08,5700000,12044087,43044087,37344087
The Inbetweeners,6,2012-09-07,5700000,35955,86051320,80351320
Valhalla Rising,7,2010-07-16,5700000,30638,731613,-4968387
Bend it Like Beckham,8,2003-03-12,5600000,32543449,74566042,68966042
Crossover,9,2006-09-01,5600000,7009668,7009668,1409668
Sunshine State,10,2002-06-21,5600000,3064356,3281898,-2318102
Standing Ovation,11,2010-07-16,5600000,531806,531806,-5068194
Khiladi 786,12,2012-12-07,5600000,385422,14683763,9083763
[Rec] 2,13,2010-07-09,5600000,27766,18527766,12927766
Diary of a Mad Black Woman,16,2005-02-25,5500000,50406346,50458356,44958356
Don Jon,18,2013-09-27,5500000,24477704,41268579,35768579
Hell Fest,20,2018-09-28,5500000,11107431,18119231,12619231
Mambo Italiano,21,2003-06-06,5500000,9282750,12399772,6899772
Ghost World,22,2001-07-20,5500000,6217849,8761608,3261608
Iris,23,2001-12-14,5500000,5580479,5580479,80479
Les Choristes,25,2004-11-26,5500000,3629758,83529758,78029758
Wonderland,26,2003-10-03,5500000,1060512,1060512,-4439488
De battre mon coeur s'est arrÃªtÃ©,27,2005-07-01,5500000,1023424,8589831,3089831
Haevnen,28,2011-04-01,5500000,1008098,15867314,10367314
Le Havre,29,2011-10-21,5500000,611709,13480196,7980196
Harvard Man,30,2002-05-17,5500000,56653,56653,-5443347
Salvation Boulevard,31,2011-07-15,5500000,28468,28468,-5471532
R100,32,2015-01-23,5500000,24956,24956,-5475044
Miss Julie,33,2015-05-05,5500000,0,863895,-4636105
Animals,34,2008-12-31,5500000,0,0,-5500000
Irreversible,35,2003-03-07,5400000,792200,8133256,2733256
Tao Jie,36,2013-02-26,5400000,0,4728896,-671104
Rang De Basanti,37,2006-01-27,5300000,2197694,29197694,23897694
Grabbers,38,2013-07-19,5300000,0,440821,-4859179
La Vie d'AdÃ¨le â Chapitres 1 & 2,39,2013-10-11,5250000,2450504,22914479,17664479
Hodejegerne,40,2012-04-27,5250000,1200010,20188740,14938740
The Ten,41,2007-08-03,5250000,769726,786677,-4463323
A Room for Romeo Brass,42,2000-10-27,5250000,20097,20097,-5229903
The Girl with all the Gifts,43,2017-02-24,5250000,0,4801837,-448163
Saint Ralph,45,2005-08-05,5200000,795126,1695126,-3504874
Dum Maaro Dum,46,2011-04-22,5200000,564489,11633427,6433427
My Big Fat Greek Wedding,48,2002-04-19,5000000,241438208,374890034,369890034
Get Out,49,2017-02-24,5000000,176040665,255367951,250367951
Split,50,2017-01-20,5000000,138141585,278964806,273964806
Paranormal Activity 3,51,2011-10-21,5000000,104028807,207039844,202039844
Saw II,52,2005-10-28,5000000,87025093,152925093,147925093
Insidious Chapter 2,53,2013-09-13,5000000,83586447,161921515,156921515
10 Cloverfield Lane,54,2016-03-11,5000000,72082999,108286422,103286422
Lights Out,55,2016-07-22,5000000,67268835,148806510,143806510
The Visit,56,2015-09-11,5000000,65206105,98677816,93677816
Jackass: The Movie,57,2002-10-25,5000000,64282312,79282312,74282312
Happy Death Day,58,2017-10-13,5000000,55683845,125010260,120010260
Paranormal Activity 4,59,2012-10-19,5000000,53900335,142817992,137817992
Ouija,60,2014-10-24,5000000,50856010,103300632,98300632
No se Aceptan Devoluciones,62,2013-08-30,5000000,44467206,100486616,95486616
The Gift,63,2015-08-07,5000000,43787265,58978477,53978477
The Big Sick,64,2017-06-23,5000000,42872467,53972860,48972860
Monster,69,2003-12-24,5000000,34469210,64240813,59240813
Paranormal Activity: The Marked Ones,70,2014-01-03,5000000,32462372,90904854,85904854
Oculus,72,2014-04-11,5000000,27695246,44115496,39115496
Dallas Buyers Club,73,2013-11-01,5000000,27298285,60611845,55611845
No Escape,74,2015-08-26,5000000,27288872,42844516,37844516
The Lazarus Effect,76,2015-02-27,5000000,25801570,38359310,33359310
Memento,77,2001-03-16,5000000,25544867,39723096,34723096
Our Idiot Brother,78,2011-08-26,5000000,24814830,25861249,20861249
The Strangers: Prey at Night,79,2018-03-09,5000000,24431472,29960051,24960051
Clerks II,80,2006-07-21,5000000,24148068,27342246,22342246
Billy Elliot,82,2000-10-13,5000000,21995263,109253745,104253745
The Way Way Back,83,2013-07-05,5000000,21502690,26853810,21853810
"As Above, So Below",84,2014-08-29,5000000,21222315,41824066,36824066
Godâs Not Dead 2,85,2016-04-01,5000000,20773069,23551286,18551286
Race,90,2016-02-19,5000000,19115191,23745772,18745772
Still Alice,92,2015-01-16,5000000,18656400,41699612,36699612
Apollo 18,94,2011-09-02,5000000,17686929,26517819,21517819
"Paul, Apostle of Christ",95,2018-03-23,5000000,17547999,25529498,20529498
Addicted,96,2014-10-10,5000000,17390770,17499242,12499242
O (Othello),97,2001-08-31,5000000,16017403,16017403,11017403
Spring Breakers,3,2013-03-15,5000000,14124286,31149251,26149251
It Comes at Night,4,2017-06-09,5000000,13985117,19720203,14720203
Y Tu MamÃ¡ TambiÃ©n,5,2002-03-15,5000000,13649881,33649881,28649881
Shaun of the Dead,6,2004-09-24,5000000,13542874,30332385,25332385
The Haunting of Molly Hartley,7,2008-10-31,5000000,13442412,15318257,10318257
Hillaryâs America: The Secret History of the Democratic Party,8,2016-07-15,5000000,13099931,13099931,8099931
Before I Fall,12,2017-03-03,5000000,12241072,18945682,13945682
Sunshine Cleaning,14,2009-03-13,5000000,12062558,17329337,12329337
Fifty Shades of Black,15,2016-01-29,5000000,11686940,22113075,17113075
Not Easily Broken,19,2009-01-09,5000000,10572742,10732909,5732909
Momsâ Night Out,20,2014-05-09,5000000,10429707,10537341,5537341
The Belko Experiment,21,2017-03-17,5000000,10166820,11792942,6792942
The Perfect Match,22,2016-03-11,5000000,9669521,10182050,5182050
Digimon: The Movie,23,2000-10-06,5000000,9628751,16628751,11628751
Saved!,24,2004-05-28,5000000,8886160,10206551,5206551
Les invasions barbares,25,2003-05-09,5000000,8460000,25913869,20913869
The Forsaken,28,2001-04-27,5000000,6755271,6755271,1755271
Fahrenheit 11/9,29,2018-09-21,5000000,6352306,6653715,1653715
Sea Rex 3D: Journey to a Prehistoric World,31,2010-05-28,5000000,6096582,16515203,11515203
Grandmaâs Boy,32,2006-01-06,5000000,6090172,6590172,1590172
Made,35,2001-07-13,5000000,5308707,5476060,476060
La mala educaciÃ³n,36,2004-11-19,5000000,5211842,40311842,35311842
Moon,37,2009-06-12,5000000,5010163,10676073,5676073
90 Minutes in Heaven,38,2015-09-11,5000000,4816142,4816142,-183858
Incarnate,39,2016-12-02,5000000,4799774,9371036,4371036
Keeping Up with the Steins,40,2006-05-12,5000000,4339241,4414753,-585247
Bottle Shock,42,2008-08-06,5000000,4078607,4815890,-184110
Des Hommes et Des Dieux,43,2011-02-25,5000000,3954651,46263525,41263525
Table 19,45,2017-03-03,5000000,3614896,4620399,-379601
Green Room,46,2016-04-15,5000000,3220371,3807503,-1192497
Thoroughbreds,47,2018-03-09,5000000,3072605,3187302,-1812698
The Other Side of the Door,49,2016-03-04,5000000,3000342,12905107,7905107
Everything Must Go,50,2011-05-13,5000000,2712131,2821010,-2178990
Kill the Messenger,51,2014-10-10,5000000,2450846,6656705,1656705
Rabbit Hole,52,2010-12-17,5000000,2229058,6205034,1205034
Jem and the Holograms,53,2015-10-23,5000000,2184640,2368937,-2631063
Paterson,54,2016-12-28,5000000,2141423,10727536,5727536
The Machinist,57,2004-10-22,5000000,1082044,8655397,3655397
American Teen,59,2008-07-25,5000000,942441,989319,-4010681
Atlas Shrugged: Who Is John Galt?,60,2014-09-12,5000000,851690,851690,-4148310
Party Monster,61,2003-08-29,5000000,742898,894030,-4105970
The Oh in Ohio,62,2006-07-14,5000000,418689,648183,-4351817
Ain't Them Bodies Saints,64,2013-08-16,5000000,391611,1075009,-3924991
Jimi: All is By My Side,66,2014-09-26,5000000,340911,927074,-4072926
"Gandhi, My Father",67,2007-08-03,5000000,240425,2015004,-2984996
Standard Operating Procedure,68,2008-04-25,5000000,228830,332120,-4667880
Tucker & Dale vs. Evil,69,2011-09-30,5000000,223838,5476793,476793
Cop Car,71,2015-08-07,5000000,134552,143658,-4856342
"Lovely, Still",72,2010-09-10,5000000,127564,282687,-4717313
Tycoon,73,2003-06-13,5000000,121016,121016,-4878984
Decoys,75,2004-02-27,5000000,84733,96760,-4903240
Stuck,76,2008-05-30,5000000,67505,67505,-4932495
Redacted,77,2007-11-16,5000000,65388,861325,-4138675
Rudderless,78,2014-10-17,5000000,56001,567219,-4432781
Fascination,79,2005-01-28,5000000,16670,83356,-4916644
Grace,80,2009-08-14,5000000,8297,8297,-4991703
Area 51,81,2015-05-15,5000000,7556,7556,-4992444
Mientras duermes,82,2012-10-26,5000000,0,9109597,4109597
Flying By,83,2009-07-07,5000000,0,4568257,-431743
The Cottage,84,2008-12-31,5000000,0,1504960,-3495040
Dying of the Light,85,2014-12-05,5000000,0,74639,-4925361
Yoga Hosers,86,2016-09-02,5000000,0,22958,-4977042
Dead Like Me: Life After Death,87,2009-02-17,5000000,0,0,-5000000
Farce of the Penguins,88,2007-01-30,5000000,0,0,-5000000
Psych 9,89,2010-12-31,5000000,0,0,-5000000
Reach Me,90,2014-11-21,5000000,0,0,-5000000
Henry & Me,91,2014-08-18,5000000,0,0,-5000000
Born of War,92,2015-01-27,5000000,0,0,-5000000
Let's Kill Ward's Wife,93,2015-01-09,5000000,0,0,-5000000
Capricorn One,94,2015-01-13,5000000,0,0,-5000000
We Have Your Husband,95,2011-12-31,5000000,0,0,-5000000
Should've Been Romeo,96,2012-12-31,5000000,0,0,-5000000
Aztec Warrior,97,2015-12-31,5000000,0,0,-5000000
Navy SEAL vs. Zombies,98,2015-09-25,5000000,0,0,-5000000
The Hatching,99,2016-03-15,5000000,0,0,-5000000
Running Forever,100,2015-10-27,5000000,0,0,-5000000
Mommy,1,2015-01-23,4900000,3498695,17536004,12636004
Obsluhoval jsem anglickÃ©ho krÃ¡le,2,2008-08-29,4900000,617228,7174984,2274984
Soul Kitchen,3,2010-08-20,4900000,276901,23347461,18447461
The Awakening,4,2012-08-17,4900000,95933,6924321,2024321
All Hat,5,2008-01-18,4900000,15198,15198,-4884802
Hostel,7,2006-01-06,4800000,47326473,82241110,77441110
Only God Forgives,8,2013-07-19,4800000,775849,4494560,-305440
Take Shelter,9,2011-09-30,4750000,1728953,4972016,222016
Tristram Shandy: A Cock and Bull Story,10,2006-01-27,4750000,1253413,3061763,-1688237
Driving Lessons,13,2006-10-13,4700000,239962,239962,-4460038
Without Men,14,2011-12-31,4700000,0,0,-4700000
Treading Water,15,2015-03-10,4700000,0,0,-4700000
Camping Sauvage,17,2004-07-16,4600000,3479302,3479302,-1120698
Barfi,18,2012-09-14,4600000,2804874,36751984,32151984
Dear Frankie,19,2005-03-04,4600000,1340891,3099369,-1500631
The Assassination of Richard Nixon,20,2004-12-29,4600000,708776,4880143,280143
Le nom des gens,21,2011-06-24,4600000,514237,9261711,4661711
Savage Grace,22,2008-05-28,4600000,434417,968805,-3631195
Out of the Blue,23,2007-10-19,4600000,728,731767,-3868233
25th Hour,29,2002-12-19,4500000,13084595,25344490,20844490
The Lobster,32,2016-03-25,4500000,9196278,18019834,13519834
Requiem for a Dream,34,2000-10-06,4500000,3635482,7389233,2889233
LÃ¥t den rÃ¤tte komma in,36,2008-10-24,4500000,2122085,12247682,7747682
Donnie Darko,39,2001-10-26,4500000,1480006,7510877,3010877
Salvando al Soldado Perez,40,2011-09-02,4500000,1400726,9330465,4830465
Nannerl la soeur de Mozart,42,2011-08-19,4500000,707885,2404639,-2095361
Spun,43,2003-03-14,4500000,410241,1022649,-3477351
Life During Wartime,44,2010-07-23,4500000,281447,281447,-4218553
Chinjeolhan geumjassi,45,2006-05-04,4500000,211667,23471871,18971871
Blackthorn,46,2011-10-07,4500000,200558,1217307,-3282693
Maggie,47,2015-05-08,4500000,187112,1027760,-3472240
Lilja 4-ever,48,2003-04-18,4500000,181655,4556982,56982
After.Life,49,2010-04-09,4500000,108596,2481925,-2018075
Mean Machine,50,2002-02-22,4500000,92723,92723,-4407277
Fong juk,51,2007-08-31,4500000,51957,51957,-4448043
Spoken Word,52,2010-07-23,4500000,32961,32961,-4467039
The Sweeney,53,2013-03-01,4500000,26345,8000366,3500366
Falcon Rising,54,2014-09-04,4500000,11774,11774,-4488226
Hansel & Gretel Get Baked,55,2013-06-25,4500000,0,0,-4500000
Fugly,56,2014-11-07,4500000,0,0,-4500000
Zipper,57,2015-08-28,4500000,0,0,-4500000
The Final Girls,58,2015-11-03,4500000,0,0,-4500000
Daisy Winters,59,2017-12-01,4500000,0,0,-4500000
Airlift (2016),62,2016-12-31,4400000,0,9969237,5569237
R.L. Stine's Monsterville: The Cabinet of Souls,63,2015-09-29,4400000,0,0,-4400000
Anna,64,2014-06-06,4357373,0,1200000,-3157373
Whale Rider,65,2003-06-06,4300000,20779666,39374600,35074600
Sexy Beast,66,2001-06-13,4300000,6946056,10158355,5858355
Paa,67,2009-12-04,4300000,199228,9791282,5491282
Snabba Cash,68,2012-07-11,4300000,188870,10212403,5912403
Nochnoy dozor,70,2006-02-17,4200000,1502188,33913542,29713542
Animal Kingdom,71,2010-08-13,4200000,1044039,8078683,3878683
George A. Romero's Survival of the Dead,72,2010-05-28,4200000,101740,101740,-4098260
Cargo,73,2011-10-21,4200000,0,313230,-3886770
High School Musical,74,2006-05-23,4200000,0,0,-4200000
Lost in Translation,79,2003-09-12,4000000,44585453,117085297,113085297
The Boy Next Door,81,2015-01-23,4000000,36006065,53401938,49401938
Monster's Ball,84,2001-12-26,4000000,31273922,43766463,39766463
Boyhood,85,2014-07-11,4000000,25379975,57273049,53273049
The Kids Are All Right,87,2010-07-09,4000000,20811365,36275469,32275469
A Haunted House 2,89,2014-04-18,4000000,17329487,21206861,17206861
The Last Exorcism Part II,90,2013-03-01,4000000,15179303,25448707,21448707
Saving Grace,95,2000-08-04,4000000,12178602,27786849,23786849
What the #$'! Do We Know,97,2004-02-06,4000000,10941801,10941801,6941801
The Darkness,98,2016-05-13,4000000,10753574,10898293,6898293
Scoop,99,2006-07-28,4000000,10525717,40103262,36103262
The Wash,100,2001-11-14,4000000,10097096,10097096,6097096
3 Strikes,1,2000-03-01,4000000,9821335,9821335,5821335
The Visitor,2,2008-04-11,4000000,9427026,19174817,15174817
The Cooler,3,2003-11-26,4000000,8291572,11131455,7131455
The Night Listener,5,2006-08-04,4000000,7836393,10770993,6770993
El orfanato,7,2007-12-28,4000000,7159147,79250193,75250193
Bug,8,2007-05-25,4000000,7006708,8302995,4302995
The Rules of Attraction,9,2002-10-11,4000000,6525762,11799060,7799060
Let's Go to Prison,11,2006-11-17,4000000,4630045,4630045,630045
Secretary,13,2002-09-20,4000000,4046737,9413956,5413956
The Real Cancun,14,2003-04-25,4000000,3816594,3816594,-183406
Samsara,18,2012-08-24,4000000,2672413,5966671,1966671
You Kill Me,19,2007-06-22,4000000,2426851,3858964,-141036
The Art of Getting By,20,2011-06-17,4000000,1430241,1989035,-2010965
Thumbsucker,21,2005-09-16,4000000,1328679,1919197,-2080803
Red State,22,2011-09-23,4000000,1065429,1983596,-2016404
MirrorMask,23,2005-09-30,4000000,864959,973613,-3026387
Holy Motors,25,2012-10-17,4000000,641054,4230426,230426
The Signal,26,2014-06-13,4000000,600896,2665322,-1334678
Poolhall Junkies,27,2003-02-28,4000000,563711,563711,-3436289
The Face of Love,29,2014-03-07,4000000,385069,1158877,-2841123
Joe,30,2014-04-11,4000000,373375,373375,-3626625
Adoration,33,2009-05-08,4000000,294244,384244,-3615756
Psycho Beach Party,34,2000-08-04,4000000,267972,267972,-3732028
The Big Tease,36,2000-01-28,4000000,185577,185577,-3814423
Polina danser sa vie,37,2017-08-25,4000000,165203,953314,-3046686
Desert Dancer,38,2015-04-10,4000000,155271,596335,-3403665
"Guten Tag, Ramon",39,2015-01-30,4000000,154356,4854356,854356
Mondays in the Sun,40,2003-07-25,4000000,146402,146402,-3853598
Manglehorn,41,2015-06-19,4000000,132270,797439,-3202561
Tau ming chong,42,2010-04-02,4000000,129078,38899792,34899792
Trust,43,2011-04-01,4000000,120016,120016,-3879984
An Everlasting Piece,44,2000-12-22,4000000,75078,75078,-3924922
Stake Land,47,2011-04-22,4000000,33245,679482,-3320518
Praia do Futuro,48,2015-02-27,4000000,20620,760678,-3239322
Sonny,49,2002-12-27,4000000,17639,17639,-3982361
13 Sins,51,2014-04-18,4000000,9134,47552,-3952448
Another Happy Day,52,2011-11-18,4000000,9120,978527,-3021473
Inescapable,53,2013-02-22,4000000,4327,4327,-3995673
Perfectos Desconocidos,54,2017-12-31,4000000,0,31166312,27166312
Geograf globus propil,55,2013-12-31,4000000,0,4454853,454853
A Lonely Place to Die,56,2012-03-20,4000000,0,442550,-3557450
Nothing,57,2003-12-31,4000000,0,63180,-3936820
The Loved Ones,58,2012-06-01,4000000,0,12302,-3987698
Purple Violets,61,2008-08-26,4000000,0,0,-4000000
Replicas,62,2012-11-09,4000000,0,0,-4000000
The Helpers,63,2012-12-31,4000000,0,0,-4000000
The Veil,64,2015-12-31,4000000,0,0,-4000000
The Perfect Wave,65,2014-07-11,4000000,0,0,-4000000
How to Fall in Love,66,2012-12-31,4000000,0,0,-4000000
Chain of Command,67,2015-09-08,4000000,0,0,-4000000
Down for Life,72,2011-01-14,3800000,41914,41914,-3758086
The Good Heart,73,2010-04-30,3800000,20930,340930,-3459070
Hevi reissu,75,2018-10-05,3800000,10153,10153,-3789847
Casa de Areia,78,2006-08-11,3750000,539285,1178175,-2571825
Four Lions,79,2010-11-05,3750000,310007,2436111,-1313889
Defendor,80,2010-02-19,3750000,44462,44462,-3705538
The History Boys,83,2006-11-21,3700000,2730296,13447998,9747998
Unknown,84,2006-11-03,3700000,26403,3355048,-344952
Billy: The Early Years of Billy Graham,86,2008-10-10,3600000,320896,320896,-3279104
UtÃ¸ya 22. juli,87,2017-12-31,3600000,0,173156,-3426844
Truth or Dare,91,2018-04-13,3500000,41411015,95127344,91627344
The Witch,94,2016-02-19,3500000,25138705,40454520,36954520
Winchester,95,2018-02-02,3500000,25091816,44378040,40878040
Empire,96,2002-12-06,3500000,17504595,18495444,14995444
Dark Skies,97,2013-02-22,3500000,17418667,27704111,24204111
Forever My Girl,98,2018-01-19,3500000,16376066,16376066,12876066
El secreto de sus ojos,8,2010-04-16,3500000,6391436,40527719,37027719
First Reformed,11,2018-05-18,3500000,3448256,3874772,374772
Pootie Tang,12,2001-06-29,3500000,3293258,3293258,-206742
Believe,13,2016-12-02,3500000,890303,890303,-2609697
La otra conquista,14,2000-04-19,3500000,886410,886410,-2613590
American Honey,15,2016-09-30,3500000,663247,2611750,-888250
The Bronze,16,2016-03-18,3500000,615816,615816,-2884184
Trolljegeren,17,2011-06-10,3500000,253444,5706638,2206638
Ira and Abby,18,2007-09-14,3500000,221096,221096,-3278904
The Masked Saint,19,2016-01-08,3500000,182695,182695,-3317305
Winter Passing,20,2006-02-17,3500000,107492,113783,-3386217
D.E.B.S.,21,2005-03-25,3500000,96793,96793,-3403207
Time to Choose,22,2016-06-03,3500000,29233,29233,-3470767
Surveillance,23,2009-06-26,3500000,27349,1396395,-2103605
The Kick,25,2011-12-31,3500000,0,40622,-3459378
The Betrayed,26,2009-06-30,3500000,0,0,-3500000
The Secret,27,2006-10-01,3500000,0,0,-3500000
2:13,28,2011-06-28,3500000,0,0,-3500000
"Batman: The Dark Knight Returns, Part 2",29,2013-01-29,3500000,0,0,-3500000
In the Name of the King III,30,2014-03-11,3500000,0,0,-3500000
Wicked Blood,31,2014-03-04,3500000,0,0,-3500000
Dawn Patrol,32,2015-06-05,3500000,0,0,-3500000
Jagten,33,2013-05-17,3450000,687185,18309793,14859793
Lords of London,34,2015-09-01,3440000,0,0,-3440000
La marche de l'empereur,35,2005-06-24,3400000,77437223,133276359,129876359
Margin Call,37,2011-10-21,3400000,5353586,20433227,17033227
Choke,38,2008-09-26,3400000,2926565,4124277,724277
L\'incomparable mademoiselle C.,39,2004-04-23,3400000,493905,493905,-2906095
August,40,2008-07-11,3400000,12636,12636,-3387364
To Write Love On Her Arms,41,2015-03-03,3400000,0,0,-3400000
Whiplash,43,2014-10-10,3300000,13092006,38969037,35669037
Bella,44,2007-10-26,3300000,8093373,12405473,9105473
Cidade de Deus,45,2003-01-17,3300000,7563397,32059295,28759295
Human Traffic,46,2000-05-05,3300000,104257,5422740,2122740
The Dead Girl,47,2006-12-29,3300000,19875,19875,-3280125
The Opposite Sex,48,2015-01-20,3300000,0,50206,-3249794
Entre les murs,51,2009-01-30,3250000,3766810,34114067,30864067
Sorry to Bother You,54,2018-07-06,3200000,17493096,18285560,15085560
Maria Full of Grace,56,2004-07-16,3200000,6529624,14441158,11241158
Beginners,57,2011-06-03,3200000,5790894,14314407,11114407
The Meddler,58,2016-04-22,3200000,4267219,5526942,2326942
Adam,59,2009-07-29,3200000,2283291,2834485,-365515
Feast,60,2006-09-22,3200000,56131,690872,-2509128
Antiviral,63,2013-04-12,3100000,0,123407,-2976593
Paranormal Activity 2,65,2010-10-20,3000000,84752907,177512032,174512032
War Room,66,2015-08-28,3000000,67790117,73975239,70975239
The Purge,67,2013-06-07,3000000,64473115,91266581,88266581
Sinister,69,2012-10-12,3000000,48086903,87727807,84727807
The Original Kings of Comedy,70,2000-08-18,3000000,38168022,38236338,35236338
Bowling for Columbine,75,2002-10-11,3000000,21576018,58240487,55240487
Martin Lawrence Live: RunTelDat,80,2002-08-02,3000000,19184820,19184820,16184820
Pokemon 3: The Movie,84,2001-04-06,3000000,17052128,68452128,65452128
Upgrade,89,2018-06-01,3000000,11977130,16553285,13553285
Dave Chappelle's Block Party,90,2006-03-03,3000000,11718595,12051924,9051924
Next Day Air,93,2009-05-08,3000000,10027047,10172519,7172519
The Deep End,98,2001-08-08,3000000,8823109,9981635,6981635
Before Midnight,99,2013-05-24,3000000,8110621,23251930,20251930
The Collector,1,2009-07-31,3000000,7712114,10473836,7473836
Let There Be Light,3,2017-10-27,3000000,7233471,7241309,4241309
Phat Girlz,4,2006-04-07,3000000,7061128,7301115,4301115
Woman Thou Art Loosed,5,2004-10-01,3000000,6879730,6879730,3879730
Real Women Have Curves,6,2002-10-18,3000000,5853194,7777790,4777790
Water,8,2006-04-28,3000000,5529144,11322573,8322573
Donât Think Twice,9,2016-07-22,3000000,4417983,4417983,1417983
Swiss Army Man,10,2016-06-24,3000000,4210454,5837111,2837111
East is East,11,2000-04-14,3000000,4170647,30438635,27438635
Whipped,12,2000-09-01,3000000,4142507,4142507,1142507
Frances Ha,14,2013-05-17,3000000,4067398,11262769,8262769
Please Give,15,2010-04-30,3000000,4033574,4570178,1570178
Thirteen Conversations About One Thing,20,2002-05-24,3000000,3287435,3705923,705923
Compadres,21,2016-04-22,3000000,3127773,7445044,4445044
Tsotsi,24,2006-02-24,3000000,2912606,11537539,8537539
Letters to God,25,2010-04-09,3000000,2848587,3237452,237452
DysFunkTional Family,27,2003-04-04,3000000,2255000,2255000,-745000
Tusk,28,2014-09-19,3000000,1821983,1887554,-1112446
The Wall,29,2017-05-12,3000000,1803064,4495262,1495262
Elephant,30,2003-10-24,3000000,1266955,10051516,7051516
Damsels in Distress,31,2012-04-06,3000000,1007535,1324299,-1675701
Oldboy,32,2005-03-25,3000000,707391,6239723,3239723
Hobo with a Shotgun,33,2011-05-06,3000000,703372,834953,-2165047
The D Train,34,2015-05-08,3000000,669688,772366,-2227634
Bachelorette,35,2012-09-07,3000000,446770,12577401,9577401
Fish Tank,36,2010-01-15,3000000,374675,5922292,2922292
Everybody Wants to Be Italian,37,2008-09-05,3000000,351416,351416,-2648584
Creature,38,2011-09-09,3000000,331000,331000,-2669000
The Bounce Back,39,2016-12-09,3000000,321910,421404,-2578596
Love's Abiding Joy,41,2006-10-06,3000000,252726,252726,-2747274
Chain Letter,43,2010-10-01,3000000,205842,1022453,-1977547
Tim and Eric's Billion Dollar Movie,44,2012-03-02,3000000,201436,223652,-2776348
Holly,45,2007-11-09,3000000,163069,163069,-2836931
The Eclipse,46,2010-03-26,3000000,133411,133411,-2866589
The Grand,47,2008-03-21,3000000,115879,115879,-2884121
Sommersturm,48,2006-03-17,3000000,95204,95204,-2904796
Fort McCoy,49,2014-08-15,3000000,78948,78948,-2921052
Just Looking,51,2000-10-13,3000000,39852,39852,-2960148
Before We Go,52,2015-09-04,3000000,37151,483938,-2516062
The Divide,53,2012-01-13,3000000,18000,156362,-2843638
Tanner Hall,54,2011-09-09,3000000,5073,5073,-2994927
My Big Fat Independent Movie,55,2005-09-30,3000000,4655,4655,-2995345
Demonic,56,2017-10-10,3000000,0,4668109,1668109
Ã l\'intÃ©rieur,57,2008-04-15,3000000,0,895932,-2104068
They Came Together,58,2014-06-27,3000000,0,82780,-2917220
Open Road,59,2013-05-21,3000000,0,47469,-2952531
Barry Munday,61,2010-10-01,3000000,0,0,-3000000
The Deported,62,2009-12-31,3000000,0,0,-3000000
Chicago Overcoat,63,2009-12-31,3000000,0,0,-3000000
Never Back Down 2: The Beatdown,64,2011-09-13,3000000,0,0,-3000000
AWOL-72,65,2015-12-31,3000000,0,0,-3000000
30 Nights Of Paranormal Activity With The Devil Inside The Girl With The Dragon Tattoo,66,2013-01-15,3000000,0,0,-3000000
Enter the Dangerous Mind,67,2015-02-06,3000000,0,0,-3000000
Something Wicked,68,2015-03-17,3000000,0,0,-3000000
Iguana,70,2014-10-27,3000000,0,0,-3000000
Four Single Fathers,71,2009-12-31,3000000,0,0,-3000000
Amnesiac,72,2015-08-14,3000000,0,0,-3000000
Unnatural,73,2015-12-31,3000000,0,0,-3000000
Close Range,74,2015-12-11,3000000,0,0,-3000000
Boynton Beach Club,79,2006-03-24,2900000,3127472,3127472,227472
Freakonomics,80,2010-10-01,2900000,101270,172867,-2727133
Griff the Invisible,81,2011-08-19,2900000,20778,25935,-2874065
High Tension,83,2005-06-10,2850000,3681066,6435262,3585262
Hustle & Flow,86,2005-07-22,2800000,22202809,23591783,20791783
Artie Lange's Beer League,88,2006-09-15,2800000,475000,475000,-2325000
Diary of the Dead,90,2008-02-15,2750000,952620,5394447,2644447
Indivisible,93,2018-10-26,2700000,3511417,3588305,888305
Lage Raho Munna Bhai,94,2006-09-01,2700000,2217561,31517561,28817561
Sardaar Ji,95,2015-12-31,2700000,0,8200000,5500000
Rejsen til Saturn,96,2008-12-31,2700000,0,5377665,2677665
Ida,3,2014-05-02,2600000,3827060,15298355,12698355
Riding Giants,5,2004-07-09,2600000,2276368,3292333,692333
Los CronocrÃ­menes,6,2008-12-12,2600000,39127,564474,-2035526
La Cara Oculta,7,2011-12-31,2600000,0,7033931,4433931
Timber Falls,8,2007-12-07,2600000,0,71248,-2528752
Silver Medalist,9,2008-12-31,2600000,0,0,-2600000
"Fat, Sick & Nearly Dead",10,2011-04-01,2600000,0,0,-2600000
A Haunted House,12,2013-01-11,2500000,40041683,59922558,57422558
2016: Obamaâs America,13,2012-07-13,2500000,33349941,33349941,30849941
Kevin Hart: Let Me Explain,14,2013-07-03,2500000,32244051,32327255,29827255
Garden State,15,2004-07-28,2500000,26782316,36028802,33528802
Religulous,19,2008-10-01,2500000,13011160,13881317,11381317
The Spectacular Now,22,2013-08-02,2500000,6852971,6916951,4416951
Hunt for the Wilderpeople,25,2016-06-24,2500000,5205471,23845533,21345533
Robot & Frank,26,2012-08-17,2500000,3317468,4934356,2434356
Sur Le Seuil,27,2003-10-03,2500000,2013052,2013052,-486948
Jesus' Son,28,2000-06-16,2500000,1282084,1687548,-812452
Saving Face,29,2005-05-27,2500000,1187266,1269705,-1230295
Brick Lane,30,2008-06-20,2500000,1094998,3838486,1338486
The Lost Medallion: The Adventures of Billy Stone,31,2013-03-01,2500000,549632,549632,-1950368
My Life Without Me,32,2003-09-26,2500000,432360,12267275,9767275
Marilyn Hotchkiss' Ballroom Dancing and Charm School,33,2006-03-31,2500000,349132,497195,-2002805
Super,34,2011-04-01,2500000,327716,593933,-1906067
Fuel,35,2008-11-14,2500000,174255,174255,-2325745
Valley of the Hearts Delight,36,2010-04-09,2500000,118666,118666,-2381334
The Other End of the Line,37,2008-10-31,2500000,115504,507446,-1992554
8: The Mormon Proposition,38,2010-06-18,2500000,100280,100280,-2399720
Sleep Dealer,39,2009-04-17,2500000,80136,108907,-2391093
Eye of the Dolphin,40,2007-08-24,2500000,72210,72260,-2427740
Underdogs,41,2013-08-16,2500000,35017,1392649,-1107351
Anatomie,42,2000-09-08,2500000,9598,9598,-2490402
The Calling,43,2009-12-31,2500000,0,0,-2500000
Alien Uprising,44,2013-06-21,2500000,0,0,-2500000
Christmas Mail,45,2010-12-31,2500000,0,0,-2500000
Stung,46,2015-07-03,2500000,0,0,-2500000
Sky Sharks,47,2017-09-01,2500000,0,0,-2500000
8 Days,48,2015-10-13,2500000,0,0,-2500000
Antibirth,49,2016-09-02,2500000,0,0,-2500000
The Rise of the Krays,50,2016-02-02,2500000,0,0,-2500000
Not Safe For Work,51,2014-12-31,2500000,0,0,-2500000
Go For It!,52,2011-05-13,2450000,180237,182358,-2267642
Thr3e,54,2007-01-05,2400000,1008849,1420418,-979582
Idiocracy,55,2006-09-01,2400000,444093,500296,-1899704
NiktÃ©,56,2009-12-31,2400000,0,1333891,-1066109
Always Woodstock,57,2014-11-14,2400000,0,0,-2400000
This is England,58,2007-07-25,2380000,327919,8739576,6359576
Do You Believe?,60,2015-03-20,2300000,12985600,14304931,12004931
Frontera,63,2014-09-05,2300000,59696,59696,-2240304
Redemption Road,64,2011-08-26,2300000,29384,29384,-2270616
The Toxic Avenger Part II,65,2015-04-15,2300000,0,0,-2300000
Eden,66,2016-01-19,2300000,0,0,-2300000
The Last Sin Eater,73,2007-02-09,2200000,388390,388390,-1811610
Impact Point,74,2008-12-31,2200000,0,0,-2200000
Chicken Tikka Masala,76,2005-12-31,2160000,0,37865,-2122135
Jack Brooks: Monster Slayer,77,2008-10-07,2150000,0,0,-2150000
Bully,79,2001-07-13,2100000,881824,1381824,-718176
Elling,80,2002-05-29,2100000,313436,313436,-1786564
Mi America,81,2016-10-16,2100000,3330,3330,-2096670
[Rec],82,2009-07-14,2100000,0,23266821,21166821
Infected,83,2012-12-31,2100000,0,0,-2100000
Lies in Plain Sight,84,2010-12-31,2100000,0,0,-2100000
The Timber,85,2015-10-06,2100000,0,0,-2100000
Sharkskin,86,2016-01-19,2100000,0,0,-2100000
Courageous,87,2011-09-30,2000000,34522221,35185884,33185884
It Follows,94,2015-03-13,2000000,14674077,23250755,21250755
Eighth Grade,95,2018-07-13,2000000,13539710,14341016,12341016
Silent House,97,2012-03-09,2000000,12739737,16610760,14610760
Das Leben der Anderen,99,2007-02-09,2000000,11284657,81197047,79197047
Hardcore Henry,100,2016-04-08,2000000,9252038,17187434,15187434
Les Triplettes de Belleville,6,2003-11-26,2000000,7301288,17403168,15403168
Winter's Bone,8,2010-06-11,2000000,6531503,16131551,14131551
Meet the Mormons,9,2014-10-10,2000000,6047363,6049171,4049171
American Splendor,10,2003-08-15,2000000,6003587,8685632,6685632
The Florida Project,11,2017-10-06,2000000,5904366,11295324,9295324
All Saints,12,2017-08-25,2000000,5802208,5941994,3941994
Before Sunset,13,2004-07-02,2000000,5792822,11217346,9217346
Amores Perros,14,2001-03-30,2000000,5383834,20883834,18883834
Thirteen,15,2003-08-20,2000000,4601043,9505996,7505996
Touching the Void,16,2004-01-23,2000000,4593598,15396525,13396525
Inside Job,17,2010-10-08,2000000,4311834,7799257,5799257
Me and You and Everyone We Know,19,2005-06-17,2000000,3885134,9615464,7615464
We Are Your Friends,20,2015-08-28,2000000,3591417,10153415,8153415
Harsh Times,21,2006-11-10,2000000,3337931,6225304,4225304
Ghost Dog: The Way of the Samurai,22,2000-03-03,2000000,3330230,10672492,8672492
Captive,23,2015-09-18,2000000,2583301,2791973,791973
Full Frontal,24,2002-08-02,2000000,2512846,3438804,1438804
Hearts Beat Loud,25,2018-06-08,2000000,2386254,2420962,420962
The Resurrection of Gavin Stone,26,2017-01-20,2000000,2303792,2303792,303792
Waltz with Bashir,27,2008-12-25,2000000,2283849,13912289,11912289
Strangers with Candy,28,2006-06-28,2000000,2072645,2077844,77844
Shortbus,31,2006-10-04,2000000,1985292,1985292,-14708
Son of Rambow: A Home Movie,32,2008-05-02,2000000,1785505,11263263,9263263
"The Book of Mormon Movie, Volume 1: The Journey",33,2003-09-12,2000000,1660865,1660865,-339135
Hamlet,34,2000-05-12,2000000,1577287,2419669,419669
The Diary of a Teenage Girl,35,2015-08-07,2000000,1477002,2279959,279959
No End In Sight,36,2007-07-27,2000000,1433319,1433319,-566681
Locke,37,2014-04-25,2000000,1370646,2088390,88390
In the Shadow of the Moon,39,2007-09-07,2000000,1134358,2175587,175587
Meek's Cutoff,40,2011-04-08,2000000,977772,1869928,-130072
The Babadook,41,2014-11-28,2000000,950792,7482387,5482387
Inside Deep Throat,42,2005-02-11,2000000,691880,691880,-1308120
Dinner Rush,43,2001-09-28,2000000,638227,1075504,-924496
The Virginity Hit,44,2010-09-24,2000000,636706,636706,-1363294
House of D,47,2005-04-15,2000000,388532,466106,-1533894
Teeth,48,2008-01-18,2000000,347578,2350641,350641
Sherrybaby,50,2006-09-08,2000000,199176,759504,-1240496
The Last Five Years,51,2015-02-13,2000000,147299,205298,-1794702
Hum to Mohabbt Karega,53,2000-05-26,2000000,121807,121807,-1878193
It's All Gone Pete Tong,54,2005-04-15,2000000,120620,2226603,226603
Saint John of Las Vegas,55,2010-01-29,2000000,102645,102645,-1897355
Pump,57,2014-09-19,2000000,72277,72277,-1927723
Roadside Romeo,58,2008-10-24,2000000,55202,2046090,46090
Eureka,59,2001-05-04,2000000,49388,76654,-1923346
Lost River,60,2015-04-07,2000000,45431,2009644,9644
This Thing of Ours,61,2003-07-18,2000000,37227,37227,-1962773
Knock Knock,62,2015-10-09,2000000,36336,6328516,4328516
Growing up Smith,63,2017-02-03,2000000,35312,35312,-1964688
Super Capers,64,2009-03-20,2000000,30955,30955,-1969045
The Missing Person,66,2009-11-20,2000000,17896,17896,-1982104
The First Time,67,2012-10-19,2000000,17061,17061,-1982939
London,68,2006-02-10,2000000,12667,12667,-1987333
Circle,69,2010-08-27,2000000,10024,10024,-1989976
Eden Lake,70,2008-10-31,2000000,7321,4294373,2294373
Jerusalema,71,2010-06-11,2000000,7294,10679,-1989321
Say Uncle,72,2006-06-23,2000000,5361,5361,-1994639
Plush,73,2013-09-13,2000000,3080,28864,-1971136
The Ghastly Love of Johnny X,74,2012-10-26,2000000,2436,2436,-1997564
Lesbian Vampire Killers,75,2009-12-29,2000000,0,3620902,1620902
Grave Encounters,76,2011-09-09,2000000,0,2151887,151887
Bone Tomahawk,77,2015-10-23,2000000,0,475846,-1524154
Freeze Frame,78,2004-12-10,2000000,0,105377,-1894623
Stitches,79,2013-04-01,2000000,0,63555,-1936445
"To Be Frank, Sinatra at 100",80,2015-12-31,2000000,0,926,-1999074
Nine Dead,82,2009-12-31,2000000,0,0,-2000000
No Man's Land: The Rise of Reeker,83,2008-10-14,2000000,0,0,-2000000
Rockaway,84,2007-07-07,2000000,0,0,-2000000
The Lady from Shanghai,86,2015-03-17,2000000,0,0,-2000000
Straight A's,87,2013-03-19,2000000,0,0,-2000000
The Legend of Hellâs Gate: An American Conspiracy,88,2012-03-30,2000000,0,0,-2000000
Highway,89,2012-12-31,2000000,0,0,-2000000
Small Apartments,90,2013-02-08,2000000,0,0,-2000000
Coffee Town,91,2013-07-09,2000000,0,0,-2000000
Lucky Dog,92,2014-12-31,2000000,0,0,-2000000
Pendulum,93,2001-12-31,2000000,0,0,-2000000
Slacker Uprising,95,2008-09-23,2000000,0,0,-2000000
The Walking Deceased,96,2015-03-20,2000000,0,0,-2000000
True Bromance,97,2011-12-31,2000000,0,0,-2000000
The Curse of Downers Grove,98,2015-08-21,2000000,0,0,-2000000
Wind Walkers,99,2015-12-31,2000000,0,0,-2000000
The Dog Lover,100,2016-07-08,2000000,0,0,-2000000
Shark Lake,1,2015-12-01,2000000,0,0,-2000000
Buried,2,2010-09-24,1987650,1044143,21270290,19282640
The Marine 4,3,2015-04-21,1950000,0,0,-1950000
Man on Wire,5,2008-07-25,1900000,2962242,5617067,3717067
Nowhere Boy,6,2010-10-08,1900000,1445366,7785229,5885229
Northfork,7,2003-07-11,1900000,1420578,1445140,-454860
Brotherly Love,8,2015-04-24,1900000,478595,478595,-1421405
Submarine,9,2011-06-03,1900000,467602,4581937,2681937
The Square,10,2010-04-09,1900000,406216,740932,-1159068
ABCD (Any Body Can Dance),11,2013-02-08,1900000,222098,10137234,8237234
Chacun sa nuit,12,2007-06-29,1900000,18435,139317,-1760683
Stranded,13,2013-07-26,1900000,0,285593,-1614407
Vaalu,14,2015-12-31,1900000,0,12444,-1887556
The Last Exorcism,15,2010-08-27,1800000,41034350,70165900,68365900
Beasts of the Southern Wild,18,2012-06-27,1800000,12795746,23265132,21465132
El crimen de padre Amaro,23,2002-11-15,1800000,5719000,5719000,3919000
Songcatcher,24,2001-06-15,1800000,3050934,3050934,1250934
Higher Ground,25,2011-08-23,1800000,841056,842693,-957307
POM Wonderful Presents: The Greatest Movie Ever Sold,26,2011-04-22,1800000,638476,783733,-1016267
Travellers and Magicians,27,2005-01-07,1800000,506793,1322161,-477839
Deadline,29,2009-12-31,1800000,0,0,-1800000
Sublime,30,2007-03-13,1800000,0,0,-1800000
Dysfunctional Friends,31,2012-02-03,1800000,0,0,-1800000
Independence Daysaster,32,2013-12-31,1800000,0,0,-1800000
Against the Wild,33,2014-03-11,1800000,0,0,-1800000
Beginnerâs Guide to Sex,34,2015-10-20,1800000,0,0,-1800000
May,36,2003-02-07,1750000,145540,634803,-1115197
I Spit on Your Grave,37,2010-10-08,1750000,93051,1278471,-471529
In the Bedroom,39,2001-11-23,1700000,35930604,42137871,40437871
La misma luna,40,2008-03-19,1700000,12590147,23271741,21571741
The Lunchbox,42,2014-02-28,1700000,4231500,12231500,10531500
Grace Unplugged,43,2013-10-04,1700000,2507159,2507159,807159
Saul fia,45,2015-12-18,1700000,1777043,9696537,7996537
My Summer of Love,46,2005-06-17,1700000,1000915,4727375,3027375
Yes,47,2005-06-24,1700000,396035,661221,-1038779
N-Secure,54,2010-10-15,1600000,2595644,2595644,995644
Sukkar banat,55,2008-02-01,1600000,1060591,14253760,12653760
Bubble,57,2006-01-27,1600000,145382,145382,-1454618
Dil Jo Bhi Kahey...,58,2005-09-23,1600000,129319,129319,-1470681
Two Night Stand,60,2014-09-26,1600000,15600,868081,-731919
I Love Your Work,61,2005-11-04,1600000,3264,3264,-1596736
Insidious,63,2011-04-01,1500000,54009150,99870886,98370886
Moonlight,64,2016-10-21,1500000,27854931,65245512,63745512
Cabin Fever,65,2003-09-12,1500000,21158188,30351664,28851664
Waitress,66,2007-05-02,1500000,19097550,22217183,20717183
Unsane,70,2018-03-23,1500000,7690044,14244931,12744931
The Squid and the Whale,72,2005-10-05,1500000,7372734,11191423,9691423
Kissing Jessica Stein,73,2002-03-13,1500000,7025722,9345061,7845061
The To Do List,77,2013-07-26,1500000,3491669,4128828,2628828
The Gatekeepers,78,2013-02-01,1500000,2408553,2592308,1092308
Iâm Not Ashamed,81,2016-10-21,1500000,2082980,2082980,582980
Nueve Reinas,83,2002-04-19,1500000,1222889,12412889,10912889
The Lords of Salem,84,2013-04-19,1500000,1165881,1541131,41131
31,85,2016-10-21,1500000,779820,922727,-577273
The Ballad of Jack and Rose,86,2005-03-25,1500000,712294,1126258,-373742
Unsullied,87,2016-04-22,1500000,510957,510957,-989043
The Believer,89,2002-05-17,1500000,406035,1840248,340248
Snow Angels,90,2008-03-07,1500000,402858,414404,-1085596
Session 9,91,2001-08-10,1500000,378176,1619602,119602
MOOZ-lum,92,2011-02-11,1500000,362239,372239,-1127761
I Want Someone To Eat Cheese With,93,2007-09-05,1500000,194568,194568,-1305432
Amigo,94,2011-08-19,1500000,184705,184705,-1315295
Hatchet,95,2007-09-07,1500000,175281,240396,-1259604
My Name is Bruce,96,2008-10-31,1500000,173066,173066,-1326934
The Disappearance of Alice Creed,97,2010-08-06,1500000,166980,1605139,105139
The Salon,99,2007-05-11,1500000,139084,139084,-1360916
The Square,100,2013-10-25,1500000,124244,176262,-1323738
Stolen Summer,1,2002-03-22,1500000,119841,119841,-1380159
Road Hard,2,2015-03-06,1500000,113169,113169,-1386831
Forty Shades of Blue,3,2005-09-28,1500000,75828,172569,-1327431
Trucker,4,2009-10-09,1500000,52429,52429,-1447571
Pontypool,5,2009-05-29,1500000,3865,31916,-1468084
"Me, You and Five Bucks",6,2015-09-28,1500000,2105,2105,-1497895
Housebound,7,2014-10-17,1500000,0,236863,-1263137
Teefa in Trouble,8,2018-07-20,1500000,0,98806,-1401194
Wal-Mart: The High Cost of Low Price,9,2005-11-04,1500000,0,58692,-1441308
Closer to the Moon,10,2014-04-17,1500000,0,5396,-1494604
Fetching Cody,11,2006-03-17,1500000,0,0,-1500000
The Lion of Judah,12,2011-06-03,1500000,0,0,-1500000
Once Upon a Time in Queens,13,2014-11-11,1500000,0,0,-1500000
Girlhouse,14,2015-02-13,1500000,0,0,-1500000
Mutant World,15,2015-05-26,1500000,0,0,-1500000
#Horror,16,2015-11-20,1500000,0,0,-1500000
Checkmate,17,2015-09-08,1500000,0,0,-1500000
Werk ohne Autor,20,2018-11-30,1400000,1303747,4331152,2931152
Mustang,21,2015-11-20,1400000,845464,5552584,4152584
The Holy Girl,22,2005-04-29,1400000,304124,1261792,-138208
La chambre bleue,23,2014-10-03,1400000,260441,1945420,545420
Incident at Loch Ness,24,2004-09-17,1400000,36830,56073,-1343927
Eddie: The Sleepwalking Cannibal,25,2013-04-05,1400000,1632,1632,-1398368
My Girlfriend's Boyfriend,26,2010-05-01,1400000,0,0,-1400000
Kurmanjan datka,27,2014-12-31,1400000,0,0,-1400000
House at the End of the Drive,28,2014-12-31,1400000,0,0,-1400000
The Girlfriend Experience,35,2009-05-22,1300000,695840,1005840,-294160
Journey from the Fall,36,2007-03-23,1300000,635305,635305,-664695
The Basket,37,2000-05-05,1300000,609042,609042,-690958
Above and Beyond,38,2015-01-30,1300000,288751,288751,-1011249
Neal n' Nikki,40,2005-12-09,1300000,100358,329621,-970379
The Hebrew Hammer,41,2003-12-19,1300000,77755,90213,-1209787
Los insolitos peces gato,42,2014-06-13,1300000,11278,54665,-1245335
Simon,43,2006-04-07,1300000,4055,1738663,438663
Forget Me Not,44,2011-05-24,1300000,0,13465,-1286535
The 41-Year-Old Virgin Who Knocked Up Sarah Marshall and Felt Superbad About It,45,2010-06-08,1300000,0,0,-1300000
The Algerian,46,2015-06-26,1300000,0,0,-1300000
Dear White People,51,2014-10-17,1250000,4404154,5403771,4153771
Filly Brown,52,2013-04-19,1250000,2850357,2940411,1690411
Bodom,54,2016-12-31,1250000,0,726460,-523540
Da Sweet Blood of Jesus,56,2015-01-13,1250000,0,0,-1250000
Saw,57,2004-10-29,1200000,55968727,103880027,102680027
Super Troopers,59,2002-02-15,1200000,18492362,23046142,21846142
Monsoon Wedding,60,2002-02-22,1200000,13876974,27025600,25825600
You Can Count on Me,61,2000-11-10,1200000,9180275,10827356,9627356
Home Run,66,2013-04-19,1200000,2859955,2859955,1659955
But I'm a Cheerleader,68,2000-07-07,1200000,2205627,2509344,1309344
Blue Like Jazz,72,2012-04-13,1200000,595018,595018,-604982
Que Horas Ela Volta?,73,2015-08-28,1200000,376976,3249041,2049041
Down & Out with the Dolls,75,2003-03-21,1200000,58936,58936,-1141064
"Pink Ribbons, Inc.",76,2012-06-01,1200000,26608,26608,-1173392
Blood Feast,77,2018-02-06,1200000,8708,8708,-1191292
Certifiably Jonathan,78,2011-02-11,1200000,7826,7826,-1192174
La navaja de Don Juan,79,2015-09-18,1200000,4254,4254,-1195746
Extreme Movie,80,2008-12-31,1200000,0,81338,-1118662
Grand Theft Parsons,82,2004-06-18,1200000,0,0,-1200000
Below Zero,83,2012-08-28,1200000,0,0,-1200000
Crowsnest,84,2012-09-07,1200000,0,0,-1200000
Airborne,85,2012-09-14,1200000,0,0,-1200000
Cotton Comes to Harlem,86,2014-09-09,1200000,0,0,-1200000
Bleeding Hearts,87,2015-02-03,1200000,0,0,-1200000
The Wicked Within,88,2013-12-31,1200000,0,0,-1200000
The Islands,89,2017-12-31,1200000,0,0,-1200000
Godâs Not Dead,90,2014-03-21,1150000,60755732,63777092,62627092
Waiting...,91,2005-10-07,1125000,16124543,18673274,17548274
Dead Man's Shoes,92,2006-05-12,1125000,6408,414736,-710264
Wolf Creek,94,2005-12-25,1100000,16186348,29005064,27905064
Ong-Bak,95,2005-02-11,1100000,4563167,24062965,22962965
Serbuan maut,96,2012-03-23,1100000,4105123,9297407,8197407
Sex with Strangers,99,2002-02-22,1100000,247740,247740,-852260
Beyond the Black Rainbow,100,2012-05-18,1100000,56491,56491,-1043509
Dracula: Pages from a Virgin's Diary,1,2003-05-14,1100000,39659,81371,-1018629
The Sleepwalker,2,2014-11-21,1100000,2636,2636,-1097364
Departure,3,2017-03-07,1100000,0,27561,-1072439
Faith Like Potatoes,4,2009-04-07,1100000,0,0,-1100000
Lake Mungo,5,2010-03-23,1100000,0,0,-1100000
Silent Running,6,2015-04-07,1100000,0,0,-1100000
The Dead Undead,7,2010-12-31,1100000,0,0,-1100000
The Vatican Exorcisms,8,2013-12-31,1100000,0,0,-1100000
Rocket Singh: Salesman of the Year,9,2009-12-11,1070000,164649,5348767,4278767
The Devil Inside,12,2012-01-06,1000000,53262945,101759490,100759490
Unfriended,14,2015-04-17,1000000,32789645,64364198,63364198
An Inconvenient Truth,16,2006-05-24,1000000,24146161,53365925,52365925
You're Next,17,2013-08-23,1000000,18494006,26887177,25887177
Chernobyl Diaries,18,2012-05-25,1000000,18119640,42411721,41411721
"Hello, My Name is Doris",22,2016-03-11,1000000,14444999,14662703,13662703
Cry Wolf,23,2005-09-16,1000000,10047674,15943081,14943081
Godzilla 2000,24,2000-08-18,1000000,10037390,10037390,9037390
Blue Valentine,25,2010-12-29,1000000,9737892,16566240,15566240
Transamerica,26,2006-01-20,1000000,9015303,16553163,15553163
Unfriended: Dark Web,29,2018-07-20,1000000,8866745,16434588,15434588
The Green Inferno,31,2015-09-25,1000000,7192291,12931420,11931420
I Am Not Your Negro,32,2017-02-03,1000000,7123919,9617402,8617402
The Sessions,33,2012-10-19,1000000,6002451,11495204,10495204
Shine a Light,34,2008-04-04,1000000,5505267,16173879,15173879
October Baby,35,2012-03-23,1000000,5355847,5391992,4391992
The Skeleton Twins,36,2014-09-12,1000000,5284309,5797192,4797192
20 Feet From Stardom,37,2013-06-14,1000000,4946250,5892466,4892466
"Food, Inc.",38,2009-06-12,1000000,4417674,4731944,3731944
An Inconvenient Sequel,39,2017-07-28,1000000,3496795,5839322,4839322
Obvious Child,41,2014-06-06,1000000,3122616,3324070,2324070
Martha Marcy May Marlene,42,2011-10-21,1000000,2981038,5438911,4438911
Junebug,43,2005-08-03,1000000,2678010,3553253,2553253
Frozen River,44,2008-08-01,1000000,2511476,6030129,5030129
Sidewalks of New York,45,2001-11-21,1000000,2402459,3575308,2575308
The Broken Hearts Club: A Romantic Comedy,47,2000-09-29,1000000,1744858,2022442,1022442
Who Killed the Electric Car?,48,2006-06-28,1000000,1678874,1849392,849392
The Secrets of Jonathan Sperry,49,2009-09-18,1000000,1355079,1355079,355079
Bubba Ho-Tep,51,2003-09-19,1000000,1239183,1492895,492895
No Man's Land,52,2001-12-07,1000000,1067481,2684207,1684207
Visages villages,54,2017-10-06,1000000,952432,4015686,3015686
Brigham City,55,2001-04-06,1000000,852206,852206,-147794
Patti Cake$,56,2017-08-18,1000000,800148,1471090,471090
Panic,57,2000-12-01,1000000,779137,1425707,425707
Palo Alto,58,2014-05-09,1000000,767732,1156309,156309
Fiza,59,2000-09-08,1000000,623791,1179462,179462
Ajami,60,2010-02-03,1000000,621859,2721096,1721096
The Future,62,2011-07-29,1000000,568662,1239174,239174
All the Real Girls,63,2003-02-14,1000000,549666,703020,-296980
23 Blast,64,2014-10-24,1000000,549185,549185,-450815
The Act of Killing,66,2013-07-19,1000000,486919,1227316,227316
Blue Car,67,2003-05-02,1000000,464126,475367,-524633
Wristcutters: A Love Story,68,2007-10-19,1000000,446165,473769,-526231
Luminarias,69,2000-05-05,1000000,428535,428535,-571465
I Origins,70,2014-07-18,1000000,336472,852399,-147601
Antarctica: A Year on Ice,71,2014-11-28,1000000,288757,288757,-711243
The Battle of Shaker Heights,72,2003-08-22,1000000,280351,839145,-160855
Taxi to the Dark Side,73,2008-01-18,1000000,274661,304472,-695528
The Invitation,74,2016-04-08,1000000,231738,354836,-645164
Guiana 1838,75,2004-09-24,1000000,227241,227241,-772759
Love Liza,76,2002-12-30,1000000,213137,213137,-786863
Once in a Lifetime: the Extraordinary Story of the New York Cosmos,77,2006-07-07,1000000,144601,215559,-784441
Lisa Picard is Famous,78,2001-08-22,1000000,113433,113433,-886567
Beyond the Brick: A LEGO Brickumentary,79,2015-07-31,1000000,101531,101531,-898469
The House of the Devil,80,2009-10-30,1000000,101215,102812,-897188
Hardflip,81,2012-06-01,1000000,96734,96734,-903266
Creative Control,82,2016-03-11,1000000,63014,63014,-936986
Chocolate: Deep Dark Secrets,83,2005-09-16,1000000,49000,1549000,549000
The Perfect Host,84,2011-07-01,1000000,48764,51587,-948413
Speedway Junky,87,2001-08-31,1000000,17127,17127,-982873
Hits,88,2015-02-13,1000000,15156,15156,-984844
The Specials,89,2000-09-22,1000000,12996,12996,-987004
16 to Life,90,2010-09-03,1000000,11574,11574,-988426
Alone with Her,91,2007-01-17,1000000,10787,844377,-155623
Camp X-Ray,92,2014-10-17,1000000,9837,101053,-898947
Special,93,2008-11-21,1000000,7202,26822,-973178
The Sisterhood of Night,94,2015-04-10,1000000,6870,6870,-993130
The Helixâ¦Loaded,96,2005-03-18,1000000,3700,3700,-996300
Childless,97,2015-05-15,1000000,1036,1036,-998964
In Her Line of Fire,98,2006-04-21,1000000,884,884,-999116
The Jimmy Show,99,2002-12-13,1000000,703,703,-999297
Heli,100,2013-12-31,1000000,0,552614,-447386
Karachi se Lahore,1,2015-12-31,1000000,0,17721,-982279
Loving Annabelle,2,2006-12-31,1000000,0,5382,-994618
American Hero,3,2015-12-11,1000000,0,26,-999974
Frat Party,4,2009-12-01,1000000,0,0,-1000000
Jimmy and Judy,5,2006-09-15,1000000,0,0,-1000000
The Party's Over,6,2003-10-24,1000000,0,0,-1000000
The Poker House,7,2009-07-17,1000000,0,0,-1000000
Proud,8,2005-09-23,1000000,0,0,-1000000
Steppin: The Movie,9,2008-12-31,1000000,0,0,-1000000
Zombies of Mass Destruction,10,2010-01-29,1000000,0,0,-1000000
Snow White: A Deadly Summer,11,2012-03-20,1000000,0,0,-1000000
Truth or Die,12,2012-10-09,1000000,0,0,-1000000
Black Rock,13,2013-05-14,1000000,0,0,-1000000
Hidden Away,14,2014-01-07,1000000,0,0,-1000000
My Last Day Without You,15,2013-10-04,1000000,0,0,-1000000
Zombie Hunter,16,2013-10-08,1000000,0,0,-1000000
Doc Holliday's Revenge,17,2014-12-31,1000000,0,0,-1000000
A Fine Step,18,2014-06-24,1000000,0,0,-1000000
Fear Clinic,19,2015-02-10,1000000,0,0,-1000000
The Pet,20,2015-03-10,1000000,0,0,-1000000
Bang Bang Baby,21,2014-12-31,1000000,0,0,-1000000
Hush,22,2016-04-08,1000000,0,0,-1000000
1982,23,2016-03-01,1000000,0,0,-1000000
The Horror Network,24,2015-10-27,1000000,0,0,-1000000
Chemical Cut,25,2016-12-31,1000000,0,0,-1000000
Por amor en el caserio,26,2015-12-22,1000000,0,0,-1000000
And Then Came Love,27,2007-06-01,989000,8158,8158,-980842
Hard Candy,28,2006-04-14,950000,1024640,8267066,7317066
Charly,29,2002-09-27,950000,814666,814666,-135334
Banshee Chapter,30,2014-01-10,950000,0,78122,-871878
Trance,31,2012-12-31,950000,0,0,-950000
Jesse,32,2014-08-12,950000,0,0,-950000
Ask Me Anything,33,2015-03-03,950000,0,0,-950000
L!fe Happens,34,2012-04-13,930000,30905,30905,-899095
Lowriders,35,2017-05-12,916000,6179955,6188421,5272421
Food Chains,36,2014-11-21,913000,0,176,-912824
Fruitvale Station,38,2013-07-12,900000,16098998,17549645,16649645
Meet the Blacks,39,2016-04-01,900000,9097072,9097072,8197072
"4 luni, 3 saptamani si 2 zile",40,2008-01-25,900000,1196321,11993156,11093156
Circumstance,41,2011-08-26,900000,454121,958978,58978
The Quiet,42,2006-08-25,900000,381420,381420,-518580
The Giant Mechanical Man,43,2012-04-27,900000,7396,7396,-892604
The Brass Teapot,44,2013-04-05,900000,6997,413733,-486267
40 Weeks,45,2014-12-31,900000,0,0,-900000
Le bonheur d'Elza,46,2015-05-05,900000,0,0,-900000
"For a Good Time, Call",48,2012-08-31,850000,1251749,1386088,536088
Latter Days,49,2004-01-30,850000,833118,865708,15708
The Hammer,50,2008-03-21,850000,442638,442638,-407362
Windsor Drive,51,2015-08-28,850000,3256,3256,-846744
Snitch,52,2012-12-31,850000,0,0,-850000
Harrison Montgomery,53,2008-12-31,850000,0,0,-850000
Celeste and Jesse Forever,54,2012-08-03,840000,3103407,3787689,2947689
Time Changer,55,2002-10-25,825000,1500711,1500711,675711
London to Brighton,56,2009-08-11,825000,0,610776,-214224
Crying With Laughter,57,2009-12-31,820000,0,16909,-803091
Jodaeiye Nader az Simin,59,2011-12-30,800000,7098492,24426169,23626169
Raising Victor Vargas,61,2003-03-28,800000,2073984,2900578,2100578
Pandora's Box,63,2002-08-09,800000,881950,881950,81950
Cama adentro,64,2007-07-18,800000,200433,200433,-599567
Deterrence,65,2000-03-10,800000,144583,371647,-428353
The Mudge Boy,66,2004-05-07,800000,62544,62544,-737456
The Young Unknowns,67,2003-04-11,800000,58163,58163,-741837
DÃ¸d snÃ¸,68,2009-06-19,800000,46742,2194020,1394020
Not Cool,69,2014-09-19,800000,35688,35688,-764312
Kill List,70,2012-02-03,800000,29063,462206,-337794
Vessel,71,2015-01-09,800000,0,0,-800000
Saints and Soldiers,72,2004-08-06,780000,1310470,1310470,530470
Iraq for Sale: The War Profiteers,74,2006-09-08,775000,0,0,-775000
Kevin Hart: Laugh at My Pain,75,2011-09-09,750000,7706436,7712436,6962436
Aqua Teen Hunger Force Colon Movie Film for Theaters,76,2007-04-13,750000,5520368,5520368,4770368
Safety Not Guaranteed,77,2012-06-08,750000,4010957,4422318,3672318
The Innkeepers,78,2012-02-03,750000,78396,1011535,261535
Il conformista,79,2014-08-29,750000,59656,89609,-660391
Interview with the Assassin,80,2002-11-15,750000,47329,47329,-702671
Undead,81,2005-07-01,750000,41196,229250,-520750
Donkey Punch,82,2009-01-23,750000,19367,814801,64801
All the Boys Love Mandy Lane,83,2013-10-11,750000,0,1960521,1210521
Destiny,84,2014-12-31,750000,0,450,-749550
Bled,85,2009-04-07,750000,0,0,-750000
Adulterers,86,2016-01-05,750000,0,0,-750000
Rize,90,2005-06-24,700000,3278611,4857731,4157731
Half Nelson,91,2006-08-11,700000,2697938,4911725,4211725
L.I.E.,92,2001-09-07,700000,1140965,1140965,440965
Columbus,93,2017-08-04,700000,1017107,1110511,410511
B-Girl,95,2010-01-26,700000,0,1160,-698840
Walter,96,2015-03-13,700000,0,0,-700000
Escape from Tomorrow,100,2013-10-11,650000,171962,171962,-478038
That Way Madness Lies,1,2018-12-14,650000,1447,1447,-648553
After,2,2012-12-31,650000,0,0,-650000
The Hadza: Last of the First,3,2014-12-31,650000,0,0,-650000
Starsuckers,4,2009-12-31,640000,0,14812,-625188
Treachery,5,2013-12-31,625000,0,0,-625000
Mercy Streets,11,2000-10-31,600000,173599,173599,-426401
Water & Power,12,2014-05-02,600000,42557,42557,-557443
Arnolds Park,13,2007-10-19,600000,23616,23616,-576384
Drunk Wedding,15,2015-05-22,600000,3301,3301,-596699
They Will Have to Kill Us First,16,2016-03-04,600000,0,7943,-592057
Crop Circles: Quest for Truth,17,2002-08-23,600000,0,0,-600000
The Maid's Room,18,2014-08-08,600000,0,0,-600000
Light from the Darkroom,19,2014-12-31,600000,0,0,-600000
Irreplaceable,20,2015-02-24,600000,0,0,-600000
The Harvest/La Cosecha,22,2011-07-29,560000,3709,3709,-556291
Julija in alfa Romeo,23,2015-12-31,560000,0,8462,-551538
Faith Connections,27,2014-09-12,550000,9111,9111,-540889
High Road,28,2012-03-06,546173,0,0,-546173
Fireproof,29,2008-09-26,500000,33456317,33473297,32973297
Open Water,31,2004-08-06,500000,30500882,55518641,55018641
Mad Hot Ballroom,33,2005-05-13,500000,8117961,9387581,8887581
The Station Agent,34,2003-10-03,500000,5801558,9470209,8970209
To Save a Life,35,2010-01-22,500000,3777210,3824868,3324868
Wordplay,36,2006-06-16,500000,3121270,3177636,2677636
The Singles Ward,38,2002-02-01,500000,1250798,1250798,750798
Sholem Aleichem: Laughing in the Darkness,39,2011-07-08,500000,1131261,1131261,631261
Osama,40,2004-01-30,500000,1127331,1971479,1471479
Groove,41,2000-06-09,500000,1115313,1167524,667524
The R.M.,42,2003-01-31,500000,1111615,1111615,611615
Mean Creek,44,2004-08-20,500000,603951,1348750,848750
Drinking Buddies,45,2013-08-23,500000,343706,407100,-92900
Never Again,47,2002-07-12,500000,307631,308793,-191207
Civil Brand,49,2003-08-29,500000,254293,254293,-245707
Monsters,50,2010-10-29,500000,237301,5639730,5139730
Lonesome Jim,51,2006-03-24,500000,154187,602789,102789
Deceptive Practice: The Mysteries and Mentors of Ricky Jay,52,2013-04-17,500000,152449,152449,-347551
The Other Dream Team,53,2012-09-28,500000,134109,314444,-185556
O Menino e o Mundo,54,2015-12-11,500000,129479,280967,-219033
Rubber,55,2011-04-01,500000,100370,680914,180914
Finishing the Game,57,2007-10-05,500000,52850,53201,-446799
Kiss the Bride,58,2008-04-18,500000,32033,32033,-467967
The Journey,59,2003-07-11,500000,19800,19800,-480200
Home,60,2009-04-23,500000,15433,44793168,44293168
The Slaughter Rule,61,2003-01-10,500000,13134,13134,-486866
The Living Wake,62,2010-05-14,500000,12232,12232,-487768
Scott Walker: 30 Century Man,63,2009-02-27,500000,6840,77121,-422879
The Californians,64,2005-10-21,500000,4134,4134,-495866
Born to Fly: Elizabeth Streb vs. Gravity,65,2014-09-10,500000,1822,1822,-498178
Detention of the Dead,66,2013-06-28,500000,1778,1778,-498222
Higher Power,67,2018-05-11,500000,528,528,-499472
Feng kuang de shi tou,68,2006-12-31,500000,0,3000000,2500000
Now is Good,69,2013-01-08,500000,0,2141436,1641436
Griffin & Phoenix,70,2006-12-31,500000,0,1355967,855967
Everything Put Together,71,2001-11-02,500000,0,7890,-492110
Drones,72,2010-12-31,500000,0,0,-500000
Enter Nowhere,73,2012-04-03,500000,0,0,-500000
Girls Gone Dead,74,2012-07-17,500000,0,0,-500000
Insomnia Manica,75,2005-12-31,500000,0,0,-500000
America Is Still The Place,76,2014-12-31,500000,0,0,-500000
The Outrageous Sophie Tucker,77,2015-07-24,500000,0,0,-500000
Subconscious,78,2015-03-10,500000,0,0,-500000
Roadside,79,2015-04-14,500000,0,0,-500000
Diamond Ruff,80,2014-12-31,500000,0,0,-500000
Love in the Time of Monsters,81,2015-02-10,500000,0,0,-500000
El rey de Najayo,82,2012-12-31,500000,0,0,-500000
Fight to the Finish,83,2015-12-31,500000,0,0,-500000
Bucky and the Squirrels,84,2013-12-31,500000,0,0,-500000
Crossroads,86,2015-06-23,500000,0,0,-500000
Alleluia! The Devil's Carnival,87,2015-08-11,500000,0,0,-500000
Brooklyn Bizarre,88,2015-12-01,500000,0,0,-500000
The Sound and the Shadow,89,2014-12-31,500000,0,0,-500000
Rodeo Girl,90,2015-12-31,500000,0,0,-500000
The Little Ponderosa Zoo,91,2015-11-10,500000,0,0,-500000
Paranormal Activity,93,2009-09-25,450000,107918810,194183034,193733034
Brick,95,2006-03-31,450000,2075743,4243996,3793996
Conversations with Other Women,97,2006-08-11,450000,379418,1297745,847745
Siakh lokhamim: ha'slilim ha'gnouzim,98,2015-11-20,450000,41260,42503,-407497
Poultrygeist: Night of the Chicken Dead,99,2008-05-09,450000,13804,22623,-427377
As It Is in Heaven,100,2014-07-11,450000,13486,13486,-436514
Mutual Friends,1,2014-07-01,450000,0,0,-450000
Rise Of the Entrepreneur - The Search For A Better Way,2,2014-12-31,450000,0,0,-450000
Moartea domnului Lazarescu,5,2006-04-28,425000,80301,581304,156304
Gory Gory Hallelujah,6,2005-01-21,425000,12604,12604,-412396
Blue Ruin,7,2014-04-25,420000,258384,437002,17002
Napoleon Dynamite,8,2004-06-11,400000,44540956,46122713,45722713
Quinceanera,10,2006-08-02,400000,1692693,2797199,2397199
Dogtown and Z-Boys,11,2002-04-26,400000,1293295,1600566,1200566
Heroes,12,2008-10-24,400000,655538,655538,255538
Tarnation,13,2004-10-06,400000,592014,1162014,762014
I Want Your Money,14,2010-10-15,400000,433588,433588,33588
Jackpot,17,2001-07-27,400000,44452,44452,-355548
Fabled,18,2004-12-10,400000,31425,31425,-368575
The Dark Hours,19,2005-10-13,400000,423,423,-399577
Viskningar och rop,20,2015-03-31,400000,0,9071,-390929
Show Me,22,2005-11-04,400000,0,0,-400000
Pancakes,23,2014-12-31,400000,0,0,-400000
Murderball,30,2005-07-08,350000,1531154,1772979,1422979
My Dog Tulip,31,2010-09-01,350000,246574,310891,-39109
51 Birch Street,32,2006-10-18,350000,84689,84689,-265311
Revolution#9,33,2002-11-15,350000,9118,9118,-340882
Royal Kill,34,2009-04-10,350000,0,0,-350000
Rotor DR1,35,2015-10-20,350000,0,0,-350000
Kynodontas,39,2010-06-25,323000,110248,1373407,1050407
Tupac Resurrection,41,2003-11-14,300000,7718961,7808524,7508524
God's Army,42,2000-03-10,300000,2637726,2652515,2352515
Pieces of April,43,2003-10-17,300000,2528664,3571253,3271253
Wendy and Lucy,45,2008-12-10,300000,865695,1416046,1116046
Old Joy,47,2006-08-25,300000,255923,399908,99908
First Morning,48,2005-07-15,300000,87264,87264,-212736
Pierrot le fou,49,2007-06-15,300000,70807,71380,-228620
3 Backyards,51,2011-03-11,300000,39475,39475,-260525
Sisters in Law,52,2006-04-12,300000,33312,33312,-266688
Nothing But a Man,53,2012-11-09,300000,17241,17241,-282759
Ayurveda: Art of Being,54,2002-07-19,300000,16892,2066892,1766892
Fighting Tommy Riley,56,2005-05-06,300000,10514,10514,-289486
Locker 13,57,2014-03-28,300000,3496,3496,-296504
The Looking Glass,58,2015-10-23,300000,1711,1711,-298289
All You Need Is Love,59,2014-10-31,300000,0,3565259,3265259
Some Guy Who Kills People,61,2012-07-03,300000,0,0,-300000
Midnight Cabaret,62,2013-08-07,300000,0,0,-300000
Teeth and Blood,63,2015-03-10,300000,0,0,-300000
Walking to Paris,64,2015-12-31,300000,0,0,-300000
Anderson's Cross,65,2010-12-31,300000,0,0,-300000
Amidst the Devil's Wings,66,2015-12-08,300000,0,0,-300000
Death Calls,67,2010-12-31,290000,0,0,-290000
Compliance,68,2012-08-17,270000,319285,830700,560700
Lovely and Amazing,71,2002-06-28,250000,4210379,4613482,4363482
Sleight,72,2017-04-28,250000,3930990,3934450,3684450
Better Luck Tomorrow,73,2003-04-11,250000,3802390,3809226,3559226
Like Crazy,74,2011-10-28,250000,3395391,3728400,3478400
Chuck&Buck,76,2000-07-14,250000,1055671,1157672,907672
American Desi,77,2001-03-16,250000,902835,1366235,1116235
November,81,2005-07-22,250000,191862,191862,-58138
Happy Valley,83,2008-03-28,250000,67665,67665,-182335
The Canyons,84,2013-08-02,250000,59671,62375,-187625
The Motel,85,2006-06-28,250000,51540,51540,-198460
On the Outs,86,2005-07-15,250000,49772,237816,-12184
Shotgun Stories,87,2007-12-14,250000,46026,284174,34174
Nightlights,88,2014-08-15,250000,21147,21147,-228853
Test,89,2014-06-06,250000,18823,18823,-231177
Along the Roadside,91,2015-03-24,250000,0,3234,-246766
Sunday School Musical,92,2008-10-21,250000,0,0,-250000
Rust,93,2010-10-05,250000,0,0,-250000
The Christmas Bunny,94,2010-12-31,250000,0,0,-250000
Ink,95,2009-11-10,250000,0,0,-250000
The Frozen,96,2012-12-18,250000,0,0,-250000
Jesus People,97,2014-04-11,250000,0,0,-250000
Butterfly,98,2010-12-31,250000,0,0,-250000
UnDivided,99,2015-02-03,250000,0,0,-250000
Horse Camp,100,2014-12-31,250000,0,0,-250000
Give Me Shelter,1,2015-02-24,250000,0,0,-250000
Rock the House,2,2011-12-31,250000,0,0,-250000
Shooting the Warwicks,3,2015-12-31,250000,0,0,-250000
The Love Letter,4,2015-08-18,250000,0,0,-250000
Western Religion,5,2015-10-09,250000,0,0,-250000
4/11,6,2015-01-01,250000,0,0,-250000
Little Big Top,8,2008-10-31,240000,7484,7484,-232516
Bronson,9,2009-10-09,230000,104979,2703762,2473762
Burn,10,2012-07-20,225000,1109276,1109276,884276
Urbania,11,2000-09-15,225000,1032075,1032075,807075
The Grace Card,18,2011-02-25,200000,2430735,2430735,2230735
Trois,20,2000-02-11,200000,1161843,1161843,961843
The Overnight,21,2015-06-19,200000,1109808,1165996,965996
Short Cut to Nirvana: Kumbh Mela,22,2004-10-22,200000,381225,439651,239651
Middle of Nowhere,23,2012-10-12,200000,236806,236806,36806
Call+Response,24,2008-10-10,200000,212989,212989,12989
The Business of Fancy Dancing,25,2002-05-10,200000,174682,174682,-25318
Hybrid,26,2002-05-10,200000,162605,162605,-37395
Baghead,27,2008-06-13,200000,140016,140016,-59984
Malevolence,28,2004-09-10,200000,126021,346106,146106
Side Effects,29,2005-09-09,200000,44701,44701,-155299
Good Dick,30,2008-10-10,200000,28835,52443,-147557
The Case of the Grinning Cat,31,2006-07-21,200000,7033,7033,-192967
Solitude,32,2005-01-07,200000,6260,6260,-193740
The Word,33,2014-03-14,200000,3648,3648,-196352
The Trials of Darryl Hunt,34,2007-06-15,200000,1217,1217,-198783
The Man From Earth,35,2007-10-19,200000,0,0,-200000
Samantha: An American Girl Holiday,36,2004-12-31,200000,0,0,-200000
Yesterday Was a Lie,37,2008-01-17,200000,0,0,-200000
Archaeology of a Woman,38,2014-09-12,200000,0,0,-200000
Sanctuary; Quite a Conundrum,39,2014-08-26,200000,0,0,-200000
Theresa Is a Mother,40,2015-09-29,200000,0,0,-200000
Perfect Cowboy,41,2015-11-10,200000,0,0,-200000
H.,42,2014-12-31,200000,0,0,-200000
Weekend,43,2011-09-23,190000,484592,1577585,1387585
Butterfly Girl,45,2015-02-27,180000,17503,17503,-162497
Arrowhead,46,2017-06-16,180000,0,0,-180000
Another Earth,48,2011-07-22,175000,1321194,2102779,1927779
Sparrows Dance,49,2013-08-23,175000,2602,2602,-172398
Heroes of Dirt,50,2015-09-04,175000,0,0,-175000
The Fits,51,2016-06-03,170000,166425,169242,-758
Lumea e a mea,53,2015-12-31,168000,0,29678,-138322
The Horse Boy,54,2009-09-11,160000,156612,156612,-3388
The Calling,55,2002-03-01,160000,32092,32092,-127908
Once,57,2007-05-16,150000,9445857,23323631,23173631
Tadpole,58,2002-07-19,150000,2891288,3270128,3120128
The Woman Chaser,59,2000-06-23,150000,110719,110719,-39281
Antarctic Edge: 70Âº South,60,2015-04-17,150000,7193,7193,-142807
Top Spin,61,2015-08-21,150000,5858,5858,-144142
Speak No Evil,62,2013-12-31,150000,0,32927,-117073
A Charlie Brown Christmas,63,2009-10-06,150000,0,0,-150000
Aroused,64,2013-05-03,150000,0,0,-150000
Escaping the Holocost,65,2015-12-31,150000,0,0,-150000
Sound of My Voice,68,2012-04-27,135000,408015,429448,294448
An American in Hollywood,70,2014-07-18,125000,0,0,-125000
The Brain That Sings,71,2015-08-11,125000,0,0,-125000
Romantic Schemer,72,2015-12-31,125000,0,0,-125000
Your Sister's Sister,73,2012-06-15,120000,1597486,3090593,2970593
The Blood of My Brother: A Story of Death in Iraq,74,2006-06-30,120000,0,0,-120000
A Dog's Breakfast,75,2007-12-31,120000,0,0,-120000
Une Femme MariÃ©e,76,2016-05-24,120000,0,0,-120000
The Work and the Story,79,2003-10-03,103000,16137,16137,-86863
The Gallows,80,2015-07-10,100000,22764410,41656474,41556474
Facing the Giants,81,2006-09-29,100000,10178331,10243159,10143159
A Ghost Story,86,2017-07-07,100000,1594798,2769782,2669782
The Lost Skeleton of Cadavra,88,2004-02-06,100000,110536,110536,10536
Cheap Thrills,89,2014-03-21,100000,59424,59424,-40576
The Past is a Grotesque Animal,90,2014-06-19,100000,20056,20056,-79944
Keeping it Real: The Adventures of Greg Walloch,91,2001-11-09,100000,1358,1358,-98642
Indie Game: The Movie,92,2012-05-18,100000,0,0,-100000
"Dude, Where's My Dog",93,2014-12-31,100000,0,0,-100000
Echo Dr.,94,2014-06-10,100000,0,0,-100000
Closure,95,2015-03-17,100000,0,0,-100000
Lunchtime Heroes,96,2015-12-31,100000,0,0,-100000
Open Secret,97,2015-03-25,100000,0,0,-100000
The Night Visitor,98,2015-11-10,100000,0,0,-100000
Tiger Orange,99,2015-07-07,100000,0,0,-100000
The Foot Fist Way,1,2008-05-30,79000,234286,234286,155286
Dawn of the Crescent Moon,2,2015-07-17,75000,8799,8799,-66201
Queen Crab,3,2015-09-29,75000,0,0,-75000
Happy Christmas,4,2014-07-25,70000,30312,30312,-39688
"Peace, Propaganda and the Promised Land",5,2005-01-28,70000,4930,4930,-65070
Absentia,6,2011-12-31,70000,0,8555,-61445
Super Size Me,10,2004-05-07,65000,11529368,22233808,22168808
Supporting Characters,11,2013-01-25,60000,4917,4917,-55083
The FP,12,2012-03-16,60000,0,0,-60000
Hayride,13,2012-12-31,60000,0,0,-60000
The Dirties,15,2013-10-04,55000,0,0,-55000
Gabriela,17,2001-03-16,50000,2335352,2335352,2285352
Tiny Furniture,18,2010-11-12,50000,391674,424149,374149
The Signal,19,2008-02-22,50000,251150,406299,356299
Counting,20,2015-07-31,50000,8374,8374,-41626
Big Things,21,2009-12-31,50000,0,0,-50000
Down and Dangerous,22,2014-02-14,50000,0,0,-50000
The Call of Cthulhu,23,2005-12-31,50000,0,0,-50000
Bending Steel,24,2015-08-04,50000,0,0,-50000
"Run, Hide, Die",25,2015-09-01,50000,0,0,-50000
The Image Revolution,26,2014-12-31,50000,0,0,-50000
A True Story,27,2013-10-25,45000,0,0,-45000
George Washington,28,2000-10-27,42000,241816,342722,300722
This Is Martin Bonner,29,2013-06-21,42000,0,0,-42000
Smiling Fish and Goat on Fire,30,2000-08-25,40000,277233,277233,237233
The Exploding Girl,31,2010-03-12,40000,25572,25572,-14428
Raymond Did It,32,2011-02-11,40000,3632,3632,-36368
Foreign Letters,33,2012-03-31,40000,0,0,-40000
Her Cry: La Llorona Investigation,35,2013-10-25,35000,0,0,-35000
Happy 40th,36,2014-12-31,35000,0,0,-35000
The Legend of God's Gun,37,2008-07-18,30000,243768,243768,213768
Krisha,38,2016-03-18,30000,144822,144822,114822
Mutual Appreciation,39,2006-09-01,30000,103509,103509,73509
Funny Ha Ha,40,2005-04-29,30000,77070,82698,52698
Down Terrace,41,2010-10-15,30000,9812,9812,-20188
Paraphobia,42,2013-12-31,30000,0,0,-30000
Emily,45,2017-01-27,27000,3547,3547,-23453
The Terrorist,48,2000-01-14,25000,195043,195043,170043
Exeter,49,2015-09-01,25000,0,489792,464792
Manito,50,2003-06-13,25000,0,0,-25000
Ten,51,2015-04-21,25000,0,0,-25000
Dutch Kills,52,2015-12-01,25000,0,0,-25000
Dry Spell,54,2014-12-31,22000,0,0,-22000
Flywheel,55,2003-12-31,20000,0,0,-20000
All Superheroes Must Die,56,2013-01-04,20000,0,0,-20000
The Front Man,57,2015-04-21,20000,0,0,-20000
Steel Spirit,58,2003-12-01,20000,0,0,-20000
The Ridges,59,2011-11-25,17300,0,0,-17300
The Puffy Chair,60,2006-06-02,15000,194523,195254,180254
Breaking Upwards,61,2010-04-02,15000,115592,115592,100592
Stories of Our Lives,62,2014-12-31,15000,0,0,-15000
Grip: A Criminal's Story,64,2006-04-28,12000,1336,1336,-10664
Tin Can Man,65,2007-12-31,12000,0,0,-12000
Dayereh,66,2001-03-09,10000,673780,673780,663780
Clean,67,2006-04-28,10000,138711,138711,128711
Cure,68,2001-07-06,10000,94596,94596,84596
On the Downlow,69,2004-05-28,10000,1987,1987,-8013
The Rise and Fall of Miss Thang,71,2008-08-14,10000,401,401,-9599
Family Motocross,72,2015-05-19,10000,0,0,-10000
Newlyweds,73,2012-01-13,9000,4584,4584,-4416
Primer,75,2004-10-08,7000,424760,841926,834926
Cavite,76,2006-05-26,7000,70071,71644,64644
The Mongol King,77,2004-12-31,7000,900,900,-6100
Red 11,78,2018-12-31,7000,0,0,-7000
Return to the Land of Wonders,80,2005-07-13,5000,1338,1338,-3662
A Plague So Pleasant,81,2015-09-29,1400,0,0,-1400
My Date With Drew,82,2005-08-05,1100,181041,181041,179941
